########################################
#....................#.................#
#...........#........#.....#......#....#
#.................#..#......#..........#
#......#..#..........#.................#
#....................#.............#...#
#........#.......#...#.#..#........#...#
#......#......#................#.......#
##...#.................................#
#...#...........###....................#
#.........#........#.#.#...............#
#..#.#...........#...#....#........#...#
#......#.............#...........##..#.#
#.#..................#.S.........#.....#
#....................#..#..............#
#....................#.#...........#...#
#...#................#.................#
##...................#......#..........#
#..........#.........#..#......#.#...#.#
#..#.................#..#..............#
##...................#.....#....##...#.#
#....#...#...........#.............#...#
#..#.#...............#.#.......#.......#
#....#....#..........#............#....#
#...............#....#...#..........##.#
#....................#.............#...#
#....##..............#.....#.#.....#.#.#
#....................#...........#.....#
#.....#........#.....#....#............#
##...................#.#..#.....#...#..#
#...............##.#.#................##
#..........##....#...#.............#...#
###...#.....#........#.#...............#
#..............#...#.#............#....#
#......#G........#...#..#..............#
#................#...#...........#.....#
#............#...#..........#........#.#
#..........#......#....................#
#......................#.....#.........#
########################################
