########################################
#.#........#......#...................##
##................#.#....#.............#
#.................#...#................#
#..............#..#.......#........#...#
#....##..#........#.#..................#
#..#..............#....................#
#.............#...#..............#.....#
#.................#.....#.#.........#..#
#...#.......#.....#..........#.........#
#.....#...........#..........#.....#...#
#.....#........#..#...................##
#..........#......#..............#.....#
#.##..............#..........#.........#
#............#.#..#....................#
##........#..#....#...#...#...#........#
#........#........#.............#......#
#.................#......#......#......#
#.........#.....#.#.#...........#......#
#..#.#............#....#........#.....##
#........G#..#.#..#......##....#.......#
#.................#....................#
#.................#....................#
##....#.........#.#......#.............#
#.................#..#..........#......#
#....#..........#.#.............#......#
#..##........#....#..........##......#.#
#.#...............#....................#
#...............#.#...........S.......##
#.................#..#..............#..#
#.................#.##.......#........##
#.#...............#..........##........#
#.....##...#............#..#........#..#
#..............................#....#.##
#......................................#
#..............#..#....................#
#...#.............#........#...........#
#.................#....................#
#.#.#.............#......#.....#..#....#
########################################
