########################################
#................#.#...................#
#....#.#...........#...................#
##............#....#...........##.#.#..#
#..................#........#.........S#
#..................#..#................#
#......#....#.#....#...................#
#.#.............#..#...........#..#....#
#.........#..##.#..#...................#
#............#.....#.........#.........#
#..#............#..#...................#
#.#................#...#......#........#
#.#..............#.#............#......#
#.......#..........#...................#
#..................#.....#.......#...#.#
#.#................#...................#
#....#...........#.#......#............#
#...........#....#.#............#......#
#.....##.#.........#.........#.........#
#................#.#.................#.#
#.........#..###...#...................#
##.................#..................##
#....#.............#....#...........#..#
#..............#.#.#.........#.........#
#.#................#...................#
#..................#...##......#.......#
#..................#.....#.............#
#..................#.#.##..............#
#....#.............#...........#.......#
#..................#....#.#............#
#.....#.......#....#......#.#..#.......#
#........#.........#.....#.............#
#.....G............#.##................#
#.........#....#...#.........#.#.......#
#.....#.#........#.#................#..#
#.........##.............#..#......#...#
##....#................................#
#..........................#...........#
#..................#................#.##
########################################
