########################################
#...#..................#...............#
#......##......#.......#.........#.....#
##...............#.....#......#......#.#
#....#..#.....................#..#.....#
#....##..#.#........#..................#
#.........#............................#
#..........#...........#...............#
#..#...................#...............#
#.............#........#...............#
#......................#...........#...#
#.........#............#...#...........#
#......................#....#.....##...#
#...............#......#.....#.......#.#
#............#.#.#...#.#...............#
#..##..#...............#.#.......#.....#
#.....................G#...#......#....#
#.......#..............#...............#
#...........#..........#...............#
#......#.#.............#...#........#..#
#...#..........#.......#...........#...#
#.............#........#......#.....#..#
#.............#.....#..#...#...........#
#.................#....#............#..#
#...........#.#........#...............#
#......................#.#........#.##.#
#......................#..#............#
##.....#...............#.......#.......#
##.................#...#........S#.....#
#....#..........#......#.........#.#...#
#.......#..............#...........#...#
#......................#...............#
#.....#................#..............##
#.............#........#.#...........#.#
#.#...#................#.........#.....#
#.................#....#........#......#
#.......##......#......#...............#
#....#.........#.....#.#......#......#.#
#.#........#...#.......#...............#
########################################
