########################################
#...............#............#..#......#
#...##..........#......................#
#..#............#......................#
#...............#....#.....#......#..#.#
#.........#...#.#....#.............#...#
#...#.....#.....#..................#...#
#.........#.....#............#.........#
##.#..S.........#....#.................#
#...............#.#...#................#
#....#...#...#..#...................#..#
#.........#.....#..#.....#.......##.#..#
#..........#..#.#.....................G#
##..............#.......#..............#
#...............#.....#...........#...##
#......#........#....#..##.............#
#...............#....#.............#...#
#..........#..#.#........#.............#
#............#..#.....#................#
#...............#.#..........#....#....#
#......#........#....#.................#
#..#...#........#..#......#............#
#........##.........#.....#............#
#....#............#........#...........#
#.......#....#.........................#
#..........#.#..#......................#
#...............#.........#.....#......#
#...............#....#............#....#
#...............#.......#..............#
#...............#......#.....#........##
#..#....#.......#...#........#....#....#
#.#.............#.........#............#
#.#.............#..#.#.................#
#.......#....#..#.#..#........#........#
#.............#.#.#..........#.........#
#...........#...#......................#
###.#...........#.#....................#
#...............#................#.....#
#....#..........#......................#
########################################
