########################################
##..#...#...................#..........#
#.........#..........#.................#
#.##...............................#...#
#........................#.#...#....#..#
#....#.....................#...####..#.#
#..#...........#.......................#
#...........#...............#....#....##
#......#...............................#
#........#.............................#
#............................#.........#
#........#.#...#..#.....#....#.........#
#....#........#......................#.#
#...................#..#.......#.......#
#.............#.....G.............#....#
#....#..........#......#...............#
##....#..........#........#............#
##.#........................#...#......#
#...#..................................#
#.....................#.#.#...#.......##
#............##..#...................###
#...................##....#...#.#......#
#......................................#
#...#######################...##########
#......................................#
#.............................#.....##.#
##........................#............#
#..............#..............#......#.#
#........#......................#......#
#.........##...#.......................#
#...##.................................#
#.#.#..........#........S...........#..#
#......................................#
#..#...#............#..#...............#
#......#.#................#............#
#.#....#...................##......#...#
#...........................#......#...#
#......#...............#..........#....#
#............#..#.........#..#.........#
########################################
