########################################
##..................#...............#..#
#.................#.#.....#....#..#...##
##......#...........#....#.............#
#...............#...#......#...........#
#...................#..#......#........#
#..#................#..................#
#...................#..........#.......#
#..#.#......#.......#.........#..#.....#
#...#...............#..................#
#...........#.......#..................#
#...................#.....#.......#....#
#..............#....#..................#
#...................#...........#......#
#.#.................#........#.#.......#
#.#...#.............#..................#
#...................#......#...........#
#..#..#.............#................###
#...#...#....#......#..........#.......#
#...........#.......#...##.............#
#...................#..........#.......#
#.#.......#.........#.....#........#...#
#...................#....#....#........#
#...................#........#......#..#
#...................#..............#..##
#.................#.#...#.....#........#
#.........#......#..#....#.............#
#...........#.......#..................#
#...#...............#...#..#.......#...#
#.#..#............#....................#
#.................#.....#.....#.....#.##
#.......#....#.........................#
#................#..#..#...............#
#...................#....#.............#
#................#G.#.#...............##
#.#.......#.#.......#.#.....#.....#....#
#...#.....#.........#.#..#....#........#
#..........#........#..#......#..S.....#
#.....#.#........#..#..................#
########################################
