########################################
##................................#..#.#
#..............#.....#..............#..#
#..#...................................#
#.......##....#...#...#................#
#.........#.....#.#.......#.#..........#
#......#.....#..#....#...#......#.....##
##.........#.....#.....................#
#....#...........#.....................#
#............................#.........#
#.#........#...............#...........#
#......................................#
#...#...........................#......#
#..........#..#....#..............#S...#
#...#..............................#..##
#......##..............................#
#..#.#........#.....................#..#
#....#.....#......#.........G..........#
#....................#........#..#.....#
#.#............#..#....................#
#.....................#...............##
#.......#.................#............#
#......................................#
######...######################...######
#......................................#
#.........................#.......#....#
##..#............#...................#.#
#......#...##................#.........#
#..#..........#.#.#..#.................#
#..#......................#............#
#.#..#..............#........#.#....#..#
#..................#.......#........#.##
#....#.......#............##.....#.....#
#.#..............#..#...#..............#
#..#...#...............................#
#....#..#....#.##...##..............####
#...........#......#...#...............#
#...........#.#.........#.........#....#
#...............#..#......#............#
########################################
