########################################
#...###.......#..............#....##.#.#
#.....#.#.............#.............#.##
##.................#...................#
#...............................##.....#
#...........#....#....#..........#.....#
##......#.......#......#...............#
#................#.#.#.............#...#
#....................#......#..........#
#...G...................#....#.....#...#
#........#.........................#...#
#..#....................#.......##..#..#
#................##............#..#....#
#........#.....#....................#.##
#...........................#..........#
#....................#............#....#
#...................##..#....#........##
#....#......#..........................#
#.....#.....#....#..............#...#..#
##..............................#.....##
#...#..................#............#..#
#......................................#
##################################...###
#......................................#
#...........#..........................#
#...#..#................#..............#
##....#..#....#.#......................#
#......#............##........#...#...##
#......#.#......#......#..........#...##
#.............................#......#.#
#......#.........#.............#......##
#........................#.............#
#.........#..................#.........#
#.........................#..#S.#......#
#...#....................#.............#
#.......#................#......#..#...#
#........................#.........#...#
#.#..............#.............#.......#
##..............#.#....#....#..........#
########################################
