########################################
#...............#....#.............#...#
#........#......#.#......S#..........###
#....#..........#......................#
#...##.......#..#.#...............#..#.#
#.........#.....#............#.........#
#....#.....#....#......................#
#.#.......#.....#....#.................#
#.....#.........#........##....##...#..#
#..#............#...#...#..............#
#...............#...................##.#
#...........#...#........#.............#
##...##.#.......#........#..#...#.....##
#...............#.......#....#.#..#....#
#...............#...........#.......#..#
##......##......#......................#
#...............#............#......#..#
#.#.............#.#....................#
#..........#....#......................#
#.....#...#..##.#........#.............#
##.......##..G..#.....#................#
#...............#....................#.#
#....#..........#..#..........#..#.....#
#.......#.......#........##.#..........#
#...#...........#......................#
#............#..#.....#................#
#...............#....................#.#
#.#....#........#......#.......#......##
#.......#...#.#.#...#...#............#.#
##..............#.....#................#
#...............#..............#.......#
#...............#.#...#................#
#...............#.............#..#.....#
#............#..#...........#..........#
#........#...#..#...#..................#
#...............................#......#
#....#.................................#
#...................................#..#
#............#..#...........#.....#....#
########################################
