########################################
##..#.....................#....#.......#
#.#.......#.........#...........#......#
#......................................#
#...........#.....G....................#
#..........#.#..........#.....#...#....#
#..........#........#.#................#
#....##.............................#..#
#................................#.....#
#.........#...............#...........##
##...........#..#............#.........#
#......................................#
#...........#......#...#...............#
#......................................#
##...############################...####
#......................................#
#.......#.................#....#.......#
##...........#...................#..#..#
#..#.....#..........#...........##.....#
#.....#.#..............................#
#...#.......#...........##.............#
#........#..#.............#............#
#.....#.#...........#S...##............#
#......................................#
#.....................#.........#......#
#...#.............##...............#.#.#
#...#..........##.#..........#........##
##.............#...#.........#.....#...#
#.......................#.............##
#..............................#.......#
#.....................#....#...........#
#..............#.......................#
#...........#.......#..................#
#.....#....#.#..............#..#....##.#
#.#...#.............#..................#
#................#...................#.#
#......................................#
#....##........................#.......#
#......#..................#....#.......#
########################################
