########################################
#..................#......#............#
#......................................#
#................#.............#.......#
#.#...#...#............................#
#..............#............#...#......#
#........................#...#...#.....#
#................#....#.#..............#
#.............#..........#..#..........#
#.....................................##
#....##.....#...##.........#..#...#....#
#........#..#..#............#..........#
#...........................#...#.#....#
#....#............................#....#
#....#.........................#.......#
#.....................#..#.............#
#................#................#....#
#...#.#.....#....#.....................#
##.............#...........#...........#
#......................................#
#####...################################
#......................................#
#.................#..##..#......##.....#
#..#...........#...........#..........##
##......#.#....S..................#....#
#..........#...........................#
#........#.#........................##.#
#.....#.....#..........................#
#....G..#.............#......#.........#
#........#..........#.#................#
#.....#...........................#....#
#......#...........#.......#...........#
#.#..............##....................#
#..............#.#....#.............#..#
#.#........#...........#......#........#
#.........................#............#
#.........#.......................#....#
#.......................#..............#
#............#.........................#
########################################
