########################################
#......#....#.....#....#...............#
#.#.............#......#..............##
#...........##....#....#....#..##..#...#
#....#.#.#....#........#..#............#
##.....................#.........#.....#
#............#.........#...............#
#........#....#........#.#..#..........#
#....#..........#......#...#...........#
#..........#...........#...............#
#......................#..............##
#................#.....#..#..........#.#
#......................#...........#...#
#.#.............#...#..#...............#
#.........#............#...#.........#.#
#......................#...............#
##..S......##..##......#.....#.........#
#.........................#....#.......#
#................##............#.......#
#......................................#
#...............#......#...............#
#......................#.....#.#.......#
#............#.........#.........#....##
#.........#............#...............#
#......................#.........#...#.#
#........#.......#.....#......#....#.#.#
#......................#......#........#
#....#.................#..........#....#
#....................#.#.............#.#
#.....#................#......#..#.#...#
#............#.........#..#.......#....#
#..###.................#..........#....#
#..........#..#........#....##.#.......#
#.....#....#...........#.......#..#....#
#........#.............#.......#.......#
#....#....##...#.......#...............#
##...G.#...............#...............#
#......................#.#.....#.......#
#...#.#.........###....#..#........#...#
########################################
