####################
#.#.......#.......##
#.S#......#........#
#.#.......#....#..##
#.........#........#
#.........#.....#..#
#.........#........#
#..##.....#.#......#
#.........#........#
#.......#.#..#..#..#
#.#...#...#........#
#.........#........#
#....##...#........#
##........#........#
#..................#
#...#.....#........#
#.........#........#
#...#.....#......G.#
#.........##.......#
####################
