####################
#.........#........#
#.S.#....##..#.....#
#.........#........#
#.........#........#
#.........#..#.....#
#.........#........#
#.........#........#
##........#........#
#.........#........#
#.#.......#.#......#
#........##........#
#..#......#........#
#............##....#
#.#.......#.....#..#
#.......#.#.#.#.#..#
#..#.....##.#...#..#
#........##..#.#.G.#
#.#.....#.#........#
####################
