########################################
#...........##..##..#....#.............#
#..#............#.#.#..................#
#...................#.....#.....#......#
#...................#...............#..#
#..........#........#....#.............#
##..............##..#....#.............#
#..........#...#.#..#............#.....#
#.....#...#.........#...#..............#
#................#..#..................#
#..#......#.........#...........#......#
#...#......#....#...#..........#.......#
#...................#..................#
#...................#...#.#...........##
#..........#........#...............#..#
#.....#.#.........#.#..................#
#.#........S.....#..#....#..#..........#
#...................#..#..............##
#..............#....#.......#......#...#
#........#..........#.............#....#
#.#.................#..................#
#...................#..##...#..........#
##..#...............#...............#..#
#....#..........#...#..................#
#...................#...........#......#
#.#.....#.........#.#..#.........#.....#
#..........##.......#..................#
#...................#....##............#
#...................#..#...............#
#....#....#...#.....#.................G#
#........#..........#....#.............#
#.............#.....#..........#.......#
#...................#...##.....#.......#
#........#..........#...........#......#
#................#.............#.....#.#
#...............#......................#
#.............##.......................#
#...#...............#.#.........#......#
#..#................#........#......#..#
########################################
