########################################
#...............................#......#
#........#.............#...............#
##....#.....#................#.........#
#............#...#.........#..#.......##
#....#......#......#...............#...#
#.#.....................##.......#.....#
#......#..............#..........#.....#
#..#...................................#
#...#..........#....#.......#..........#
#...........#.......................#..#
#...#...................G..............#
#.............#.....#........#.........#
##.#........#..........................#
#......#.................##.....#......#
#.......#......#..####..#.#..#..##.....#
#.........................#.........#..#
#......................................#
##...###########################...#####
#......................................#
#...#...................#..##..........#
#.#.#..................#........#......#
#...........S..........................#
#..#.....#...........#.........#.......#
##.........#.#.......................#.#
#......................#.......#.......#
#....#.....#..........#.....#.#.#......#
#...#..............#.....#.............#
#...................................#..#
#.........#.#..#........#..............#
#....#.#.........#.....................#
#.....................#....#...........#
#............#....#....................#
#...............#...#.................##
#..............#.............#.........#
#....#..............#..................#
##...#...#............#............#...#
#.....#...#...................#........#
#......................................#
########################################
