########################################
#..#.#.................#...............#
##.....................#....#..........#
#...#......#.....G.#...#...............#
#..#............#......#..........#..#.#
#...#..................#........#......#
#...............#......#....#..........#
#....#...........##....#....#.#........#
#.................#....#..........#....#
#......................#...##.........##
#.......#......#....#..#...........#...#
#...#...#.........#....#...............#
#.........##.#.........#............#..#
#......................#...............#
#..##.........#.....#..#............#..#
#..#...................#...#...........#
#..............#.......#..........#....#
#......................#............#.##
#...#..................#...............#
#............#.........#...............#
#......................#...............#
#......#...............#..........#.#..#
#.......#........#.....#.....#........##
#......................#...........#...#
#..........#...........#........#...#..#
#.........#............#....###........#
##.....................#...............#
#....#.....#...#...#.#.#...............#
#...#...........................#......#
#.......#............................#.#
#..........#......#....................#
#............#...#.....#.#..........#..#
#.............##.......#...............#
#......##.#............#...#....#......#
#...#...........#......#.....#..#......#
#..#.......#.....#.....#...#........#..#
#.#.....#........S.....#......#...#....#
#.....#................#...............#
#......................#.......#.......#
########################################
