########################################
#......................#......##.......#
#.......#.....#........#.....#.........#
#...........#..........#............#..#
#.....#................#..#............#
#..#.....#.....#.......#.............#.#
#..#...................#...............#
#.....#.....#........#.#.....#..#....#.#
#...##........#....#...................#
#....#.........#...#.....#.........#...#
#................#..............##...#.#
##....#................#...............#
#......#...............#........#......#
#..............#.......#..#............#
#.#.....#...........#..#....#..........#
#.....#....#...........#...............#
#..#..#................#........#......#
#...................#..#..#............#
#.................#....#...............#
#..#......#....#.......#...........#...#
#.#..#.................#...............#
#..........#...........#.....#.........#
#........#.....#.......#...#.....#.....#
##....#......#..#......#..........G....#
#...........#..........#.......##......#
#..............#....#..#...............#
#.................#....#.........#.....#
##........#............#.............#.#
#..##......#S..........#......#........#
#.##.#..............#..#...............#
#........#.............#.............#.#
#......................#...............#
#................#.#...#...............#
#...#...#..............#......#........#
#....#.........#.#.....#...............#
#.......#..#...........#..##...........#
#.....#.#..............#...........#...#
#.....#......#.........#......#.#......#
#..............#.#.....#.........#..#.##
########################################
