########################################
#...........#..........#...............#
##.....................#.#...........#.#
#.....#....#....#......#.........#.....#
#........#..#..........#...............#
#...#............#..#..#.............#.#
#............#....#....#...G...........#
#...........#..........#.#.............#
#......................#...##.#..##....#
#..............#.......#....##.....#...#
#............#..##...#.#.........##....#
#..............#.......#...............#
#....#.....#...........#...............#
#...............#......#.......#...#...#
#.............#....#...#....#..........#
#....................#.#...............#
#......#..#............#.###...##....#.#
#......#.........#.....#.....#.......#.#
#..........#.#.........#...............#
#...#.#...#............#........#......#
#............##........#...#...........#
#.#............#....#..#...............#
#......................#...............#
#......................#............#..#
#..#.....#.............#...............#
#..........#...........#.#........#....#
#.......#..............#...............#
#...............#......#...............#
#..............#...#...#..#.....#.##...#
#....#.................#...............#
#.................#....#...........#...#
#..#...#...#...........#.....#.........#
#......................#.#.............#
#................S.....#.###...........#
#.......#...#...#......#.............#.#
#.....##....#...................#....#.#
#.......##..#......#..........#........#
#...........#..#.....#.....#.....#.....#
#........#.............#......#........#
########################################
