########################################
#.....#...................#......#.#...#
#....................#.#..#............#
#.........#...............#..........#.#
#...........#.#...........#...#........#
#..#........#.......#.....#...........##
#.................##......#.....#......#
#..#........#.............#.#....#.....#
#................#........#............#
#.........................#............#
#.........................#............#
##......##................#............#
#........##......#....#...#.....#......#
#........#................#..#.......#.#
#.........#......#...#....#.#..........#
#...#................#....#....#......##
#.........................#.........#..#
#............#......#.....#............#
#.#.....#.......#.........#............#
#........##.#.............#......#.....#
#.........#..#........................##
#..#...................#...............#
#.................#.#.............#....#
#..#....#.........#...#...#....#.......#
#...#......#..............#.#..........#
#...#..#....#..........#..#....#.......#
##........................#............#
#.G..........#.........#..#.....#.....##
#.....#.#............#....#........##.##
##.......#.........#......#...........##
#................#........#............#
#..##.....................#.....#..#...#
#....#....................#............#
#.#......#................#............#
#...............#.........#.........#..#
#.......#...........#.....#......S#....#
#...........#.........#...#........#...#
#..#...##....#............#............#
#...........#.............#..#.........#
########################################
