########################################
#.#...................S.........##.....#
#...........................#..........#
#..#........#.....#....#...............#
#.......#.#...........#..............#.#
#...#.....#................#......#....#
#.......................#....#......#..#
#.....#.........#....##................#
###....................................#
##................#..#....#........#...#
#.....#................#.......#.......#
#...#........................#.......#.#
##.#.............#.....................#
#.......................#.........#....#
#......................................#
####################################...#
#......................................#
#......................................#
#.........#..#....#....................#
#.#............#............#..........#
#............G.........................#
#...........................#.......#..#
#...#..#......#...#......##............#
#.................#..........#...#..#..#
#..........#....#....................#.#
##................##....#......#..#....#
#.#...........#........................#
#...#........#...#...............#....##
#...............#.....#.#..............#
#......#...#...........#...............#
#.#..............#....#...#............#
#........#.............................#
#...................#..................#
#..........##..#..................#....#
#......#.....................#.........#
#....##.......#......#...#.........##..#
#......#....#.............#.#..#.......#
#....#.............#.......#...........#
#....#..............................#..#
########################################
