########################################
##................#.#...#..#....#......#
#..#....................#..............#
#.......#...............#..............#
##................#.#...#............#.#
#.....#....#............#..#.....##....#
#.............#...###...#...#.......#..#
#...............#.......#.....#...##...#
#.......................#..............#
#...............#....#..#..#.........#.#
#.......................#..##..........#
#...##..###................#...........#
#..#..#.............................#..#
#................#.............#...#...#
#..................#....#....#.........#
##......................#..............#
#.......................#...#..........#
#..#..................#.#..............#
#.....S.#..##...........#..............#
#.........#......#.G....#..............#
#.......................#.....#........#
#....#.....##...........#..............#
#...#..#...#............#..............#
#...#..............#..#.#....#.#.#.....#
##...##..............#..#..............#
#.......................#......#.......#
#.............#.....#...#..............#
#............#.....#....#..............#
#.......................#.........#....#
##..........#......#....#..........#...#
#........#.....#.....#..#..#.......#..##
#.#........#............#..............#
#.............#.#.......#............#.#
#.............#.........#.#............#
##.#.....#..............#.#...#.......##
#.................#.....#.....#........#
#.............#.........#.........#.#..#
#.......................#..#...#.......#
#.......#....#..........#..............#
########################################
