####################
#.#.......#..#.....#
##S......##..#.....#
#.........#.#......#
#.....#...#........#
#....#....#.###....#
#.........##.......#
#.........#........#
#........##........#
#.#.......#........#
#...#..#..#.#....###
#........##........#
#.....#.#.#........#
#.........#........#
#.........#........#
##............#....#
#..#......#...#....#
#...#....##.....#G.#
#.........###.....##
####################
