########################################
#.....##.......#.......................#
#......#.......#...#..............#....#
#....#....#....#.........#.............#
#.#............#.......................#
#..#...........#...............#.......#
#.#............#..#.........#..........#
#........#.....#......#...##...........#
#..............#.........#.............#
#.....#........#.......................#
#....................#.........##......#
#.#...#.#..............#..#.......#....#
#......................................#
#...#.#..#.....#.................#.....#
#..............#...#.#..#..........#...#
#..............#.......................#
#..............#.......................#
#.#......#..#..#..#.....#...........G..#
#.....##...###S#..............#.#......#
#...##.........#....................#..#
#..............#.......................#
#.......#......#..............#........#
#.........#....#.......................#
#...#..........#........#.........#....#
#.........#....#.#.................#...#
#............#.#.....#...#........#....#
#..............#.......................#
#..............#.....................###
#...#......#...#......#................#
##....#........#......#.....#.#......#.#
#...#........#.#...............#.......#
#.#....#.......#.......................#
#.................#..........#...#.....#
#.....#......#.........................#
#................#.#.#............#..#.#
#...#.......#..#.................#.#...#
#......##......#.......................#
#..............#.................#.....#
#...........#..#.................##....#
########################################
