########################################
#..#.#......#.....#.#..................#
#........#..........#.........#........#
#......#......#.....#..................#
#...................#..............#...#
#............##.....#........#.........#
#...................#..................#
#...#..#.....#......#..................#
#....#..........#...#.#................#
#.#.....#S.......#..#..................#
#...#......#....#...#......#...........#
#......#.......#....#..#........#......#
##.#..........##....#.................##
#...................#..#........##.....#
#.#...#....#......#.#.......#.....#....#
##.....##......#....#.#................#
#.....#.............#..................#
#...................#..........##....#.#
#...............#...#............#.#...#
#.............#.....#..#...............#
#.#..............##.#G...............#.#
#...................#........##........#
#...#..................................#
#.............#...........#............#
#......#......#.#......................#
#...................#.#..............#.#
#...................#....#........#....#
#...........#...#...#........#.....##..#
#....#..#...........#.......#..#.......#
#.........#.........#.............#....#
#...................#..................#
#.........#.#.......#.....#.##.........#
#..#..#...#.#.......#..#.......#.......#
#.#...........#.....#..................#
##............#.....#..................#
##......#...........#..................#
#..#.......#........#.......#....#.....#
#....#....#.....#...#..................#
#..#.....#....#.....#..................#
########################################
