########################################
#.......#.....#.#...........#..........#
#....#..#..##...#.........#..#.........#
#..##.......................#..........#
#......................................#
##.................................##..#
#..#.....#......#..#...................#
###....#........#....................#.#
#...........#...#......................#
#.#....#........#..............#..#.#..#
#.........#.....#.....#.#..............#
#.........#.....#.....#................#
#..#..#.........#......................#
#...............#...................##.#
###.............#......................#
#...#...........#..........#........#..#
#..#............#................#...#.#
#...#...........#...........S..........#
#...............#............#.........#
###...#.........#.........#.##.........#
#.......#....#..#......................#
#...........#...#...............#......#
#....#..#.......#..................#...#
##..............#...................#..#
#.#.............#......................#
#.........#.....#..#.#.................#
#..#..#.......#.#......................#
#.#...........#.#.....#.......#......#.#
#...#.........#.#.......#..##.#........#
#......#........#......................#
##.........#....#.........#..#........##
#...............#....#.................#
#....#..........#..........##........#.#
#...............#.......#.#..#.##...#..#
##G#........##..#...##...#.........#...#
#.#........#..#.#........#.............#
#.......#....#....................#..#.#
#......##.....................#........#
#.....#....#..........#..#..#..........#
########################################
