########################################
#..#......#.......#...............#....#
##.........#......#......##............#
#....#............#....#...#.#.........#
#...........#..........................#
#......#......#.#...................#..#
#..........#............#..#.....####..#
#....#.#..........#.......#..#.........#
#....#...#........#......#.............#
#.................#..........#.##......#
#.................#...............#....#
#.................#...............#.#..#
#..#.#.....#......#...#........#.......#
#........#........#....................#
#............#....#.....#..............#
#.................#..#..#.#............#
#.#...............#..##..#............##
#.....#...........#......#.............#
#.................#..G.#.......#..#....#
#......#.......#..#.............#......#
#.................#....................#
##......#..#......#.....#..#...........#
#...............#.#.......#......#.....#
#...............#.#..........#.........#
#.................#..#.......#.....#...#
#.................#..#.................#
#..............##.#.......#...#........#
#.........#...#.#.#....................#
#.#....#...#......#.....#.........##...#
#...#.............#....................#
#.................#........#...........#
##......#.........#........#......#....#
#......#......#.#......##..........#...#
##.......#.............................#
#.....................#..#.............#
##.........#....#.#...S..#..........#..#
#.................#...................##
#.................#.....#.#.........##.#
#......#....#.....#..#...#..#........#.#
########################################
