####################
#.......#.#........#
#.S.......#........#
#.#.#.....#........#
#.#.......#........#
#..#......#........#
#.........#........#
#..#......#.....#..#
#........##........#
#.......#.#....#...#
#..#...#..#........#
#.........#.#......#
#.........#....#...#
#..#......#...#....#
#.........#...#....#
#......#..##..#..#.#
#......#..#........#
#............##..G.#
#.........#........#
####################
