########################################
#............#.......................#.#
#..#.......#..................#........#
#.........#............................#
#.........#...............#...#.......##
#.....S.......#........................#
#.....................#................#
#.........#....#.......#....#..........#
#....#................................##
#....#................................##
#...............................#.#..#.#
#...#....#......#.#....................#
#......................................#
####################################...#
#......................................#
#.......#.........##.......#.......#...#
#...................##........#..##....#
#....................##................#
#..........#....##.................#...#
#....#.#.#.....#...............#.......#
#...#............#............#......#.#
#....#..#.#...........#..............#.#
#..............#................#......#
#.......#....#..................##....##
#..........#..........#..........#.#...#
#......................................#
#...........................#.#........#
#.............##..........#...#........#
##.#......#.....#......#...............#
#.....................#.#..#...........#
#.....#.......................#..#.....#
#.#.....................#....#.........#
#....#.....#.................#.....#...#
#...#.......#..#.......................#
#..#......................#............#
#...#.......#.#........................#
##.........#.#......................#..#
#.........#..#..................G.#....#
#...............#.............#........#
########################################
