########################################
#..............#.##....................#
#.............#.......#...............##
#.........#...#........................#
#......#......#...........#............#
#......#.............#...........#...#.#
#...........#.....................#....#
#.......#...#....#.....#.#......#.#....#
#....#.##...................#...#....#.#
#...#..#.....................#.........#
#........................#......#......#
#................#......#....G......#..#
#.#.....#..##..........................#
#...........#...#......................#
#..................#...................#
#......................................#
###########...######################...#
#......................................#
#...................................#..#
#.#..#...................#........#....#
#.......#........................#.....#
#.................#....#...............#
#.#..........#...#.....................#
#.............#......#..........#......#
#...#.....................##...........#
#.....#.....................#.#........#
#......................#...............#
#..#....#....#.............#.......#...#
#..............#.........#..#.......#..#
#.#...................#.#..............#
#......................................#
#.......................#....#........##
#........#....#......................#.#
#.......................#........##...##
#.#.............#.#......#.............#
#...#.#.........S.........#............#
#.........#....................#.....#.#
#..#..#...............#..#.....#.....###
#............#..................#......#
########################################
