########################################
##................................###..#
#.................#...#................#
#..........#.#......#.........#........#
#...........#..#......#...#............#
#.....#......#...................#.....#
#.............................#....#..##
#......#..............#.......#........#
#........##.#..............#..#.#......#
#......................................#
#...#..........#..................##..##
#....................................#.#
#..#.#..........#.........#...#.#......#
#..........#...........................#
#.....#...#...#........................#
#....##.....##..................#.....##
#.....#......................###......##
#......................................#
#....##..........##...........#........#
#.........#........#.........#.........#
#................#...#.................#
#...#................#..........#....#.#
#....G.................................#
##...##############################...##
#......................................#
#...#.......#.......................#..#
#...........................#....#...#.#
#...........#.......#.....#............#
#............#.....#...................#
#........#.#...............#...........#
#.#...........#.........#..#..........##
#..........#........#.....#........#...#
#..#.......S.#......#............#.....#
#......................................#
#...........................#.#......#.#
#.#..##........#.......................#
#....#.................................#
#......................................#
#...........#...#.........#...#........#
########################################
