########################################
#........#....#..........#........#....#
#.....#..................#..#..#...#..##
#......#.#...#...#.......#.............#
##........#..............#.#...........#
#........................#.............#
#........#...............#.............#
#................................#...#.#
#.....................#..............#.#
#.#........#.........................#.#
#...........#............#...##....#...#
#..........#.#........#..#.....#.......#
#.....#....#..#.#.....#..#........#....#
#.............#..........#.............#
#....#...................#..#..........#
#...G...#................#..#....#..#..#
#.#.........##...........#.#...........#
#........................#.............#
##.......#...............#.#......#....#
#.#...................#..#.............#
#....#....#..............#.............#
#........#..........#....#......#..#...#
#...#......#....#...#....#.............#
##.......................#.............#
#..#.....................#.......#....##
#........................#.#...........#
#.........#..............#...........#.#
#....#...#........#......#........#....#
#..........#.............#.............#
#....................#...#.......S....##
#...#..#.......#.........#.............#
#.....#..................#.....#.......#
#.#............##....#...#......##.....#
#............#....#......#.#...........#
#.#....#......................#.......##
#....#...........#..#..................#
#......#.....#......#..............#...#
#.....##.................#.........#...#
#..............#.........#.........#...#
########################################
