########################################
#........#....#...#.....#..............#
#............#....#...........#.#...#..#
#.................#.........#..##......#
#.................#..#..............#..#
#.................#.............#......#
#......#..........#..#..#..#.#.....#...#
#..#.........#....#....................#
##..................................#..#
#.......................#....#....#....#
#....#........#.......#................#
#.................#.....##.............#
#..#.......#...#..#............#......##
#....#............#.......#......#.....#
#.................#....................#
#.....#.........#.#..........#........##
#....#.......#....#...#................#
#....#............#....#...............#
#.................#...........#........#
#.................#..#..........#..#...#
###....#..##......#...........#.......##
#...........#.....#..#.#.........#.....#
#...#..#.......#..#......#.........#.#.#
#........#.....#..#................##..#
#.................#....................#
#..#...#..........#..#.#...............#
#.................#..........#...#.....#
#......#..........#....................#
#...S.....#.......#.#.#............#...#
#.#...............#.##...#.........#...#
#.................#.......#............#
#......#..........#...#.........#......#
#.........##......#..#............#....#
#........#........#....#......#..G.....#
#.......#.........#.#.....#....#.......#
#.......#..##.#...#.......#............#
#..#.......#......#............#.#.....#
#...............#.#.#...#..#...##......#
#.................#...........#.....#..#
########################################
