####################
#.....#...#.....#..#
#.S#......##.......#
#.#.#.....##.......#
#..#...#..#........#
#.........#........#
#.........#........#
#........##........#
#....#....##......##
#.........#..#.....#
#.........#........#
#.........#.....#..#
#......#...........#
#.........#........#
##........#........#
#...#.#...#......###
#.........#......#.#
#.........#......G.#
#.......#.#........#
####################
