########################################
#.#............#..........#............#
#......#......#........####.#..........#
#......................##..............#
#...............#.#....#......#..#.....#
#.##...........######..#...............#
#...................####.####..........#
#.#....#.......##..##..#.#..#..........#
#..#...........#.####..###..#......#...#
#..............#.####.##.#..##.........#
#............#############...#.........#
#..............#.#.##.#......#......#..#
##.......##.#..#.#.##........#.........#
#........#..#..#...#.........#.........#
#........#..#..#.###....#....#.........#
#........#..#...#............#......#..#
#........#..#...............######.#...#
#........#.##..#............##...#.....#
#..............#............##...#.....#
#.......#...................##...#.....#
###.........................##...#.....#
#.........#..........#......##...#.....#
#..#...........S.#...........##........#
#............................#..G......#
#............................##........#
#.................#..........##....#...#
#............................##....#...#
#...#...................#....##....#...#
#..............#.............##....#...#
#............................##....#...#
#....#................#......###.###...#
#............................#........##
#............................#.........#
#.....#......................#.........#
#...#........#...#...........#........##
#.......#.........#..........#.........#
#.................................#....#
#............................#.........#
#..............#..................#....#
########################################
