########################################
#......................................#
#..........................##..........#
#.........#######################......#
#.......#.....#........................#
#..........#.............######........#
#...................#....#....#........#
#..####.......................#........#
#..#..##.................#.####........#
#..#..######.##....#####....#..........#
#..#..#....#.......#...................#
#.....#....#.......#...................#
#..####....#...##..#..........#.#......#
#.....######....#G.#.....#......#......#
#...............#..#####........#......#
#.......##......#........#......#......#
#...........#...#............#..#......#
#....########################...#...##.#
#...............#......................#
#...........#...#...............#......#
#...............#.......#########.#...##
#......#.......##.......#..#...##......#
#.......................#..#...##......#
#...............#.......#..#...##......#
#...#...........#.......#..#S...##.....#
#...............#...............#......#
#.....#####.....#...................#..#
#.....#...#.....#......................#
#....#....#.....#......................#
#.#...#####.....#.................#...##
#...............#......................#
#...............#...#..................#
#........#...........#.....#.......#.#.#
#...............#......................#
###....................................#
#.................#...............#....#
#....#.............................#...#
#.#....................................#
#...............#..................#..##
########################################
