########################################
#..................#.............#.....#
#............#.........................#
#......................................#
#........#.............................#
#..........#................####.......#
#.........###.#...#.........#..#.......#
#..#..........#.............#.##.......#
#.....#####.#.#....######...##.#.......#
#........##...#....#...............#..##
#........##.###....#..#................#
#.#......##.#......#......#.........#..#
#.....#.###.#......#.####..............#
#...######..#............#.............#
#...#....#..#..........................#
#...#....#..#....#.####............##..#
#...#....#..#..######.#................#
#..#########################.#.........#
#...######..##.#.##.#.#.........#......#
#........#..##.######.#................#
#........##.###..######................#
#.......##..##....#.....#..............#
#........#..#.#####...#...#............#
#........#..#............#.............#
#........#..#..........................#
#........#####..........#..............#
#G.......#..##.....#.#S................#
#........#..##.................#.......#
#........#####.........................#
#........#..#...............##.........#
#.#....#.#..#..........................#
#........#..#..........................#
#........#..#...#......................#
#........#....#......................#.#
#........#.............................#
#........#.............................#
#........#...............#...#........##
##.......#.....#.......#...........#...#
#.......#..................#...........#
########################################
