########################################
#.........................#..#.........#
#........###...........................#
#........#.####.#.#..........#.........#
#.....#..#..#...#............#.........#
#.....#..#..#...#.....#................#
#.....#..#..#...#..............#..#....#
#.....#.........#......................#
#.....#....######.....G...#............#
#.....#.................#..............#
#.....#..................#.####........#
#.....#............#...#...#....#......#
#.....#....#...........#...#..#...#....#
#.....#.....################..#........#
#.....#.........#.##...#...####........#
#.....######....#..#..######....######.#
#.....#....#....##.#....#.......#......#
#..#..#....#....#..#............#......#
#.....#....#....#..#.......#..#.########
#.....#....#....###....................#
#.......#..#................#........#.#
##....#..#.............................#
#..#..#..#.............................#
#.....#####.################...........#
#.....#..#...........#####.............#
#.....####........#..#...#........#....#
#..#..#..............#...#...#.....#...#
#.....#....##.#......#...#.............#
#.....#.#.##...#.........#.............#
#.....#.#..#.#.#.....#...#.............#
#.......#..#...........................#
#.....#.#..#.###.......................#
#...#......#.....S...#.................#
#......######..........................#
#.........................#............#
#......................................#
#...#..........#.......................#
#....................#.................#
#................................#.....#
########################################
