########################################
#..........#...........................#
#..........#........####...............#
#..........###.###.....#...............#
#..........#.....#..#..#...............#
#..........#.##..#..####....###.#......#
#..........#.##..#...#.......#..#......#
#..........#.##..#........#..#..#......#
#.......##########...........#.##...#..#
#..........##................#.##.....##
#..........##................####......#
#.....#....##......#...........#.......#
#.......#####.#....#...........#.......#
#.....#....##.#....#...........#.......#
#.....#....##.#....##..........#.#....##
#.....#....##.#.####....#......#.......#
#..#..#.#..##............#.....#.......#
#..#..#.#..##..................#.......#
#..#..#.#..##.....####.........#.......#
#..######..##.....#..#.........#.......#
#.....#....##.....#..#.........#.......#
##...##....##.....####..###....#.......#
#.....#...####..........#..#...#.......#
#.....#....##...........#..#...#.......#
#.....#.....#...........#..#.###.#.....#
#..#..#...G.#......#...#...#.#.#.#.....#
#.....#....###..........####.#.#.#.....#
#.....#....###...............#.###.....#
#.....#....#####.............#.#.#.....#
#.....#....##..#.....#.................#
#..#..#...###....#.............#.......#
#...#.#....#####.......................#
#S....#.....#......#...........#.......#
#.....#.....#...#..............#.......#
#.....#.....#......#...........#.......#
#..#..#.....#..................#.....#.#
#...........#..........................#
#...........#...........#....#.........#
#.........................#............#
########################################
