########################################
#.....#................................#
#...................................#..#
#..........................#...........#
#......................................#
#.................#...................##
#.................#.......#............#
#......................................#
#...................#...............#..#
#........#............#.........S#.....#
#.#.....#...........######.............#
#..............#....#..................#
#.##.............#..#....#.............#
#.#...............#.##.###.............#
#.................#....................#
#.....#############################....#
#.................#....................#
#.................#....................#
#.................#............G.......#
#...........#.....#........#...........#
#.................#....................#
#.................#.#...#..............#
#.................##..........#........#
#..##.............#....................#
#....#............#...####........#....#
#.................#.#.#..#.............#
#.................#...#..#......#..#...#
#....#................#..#.............#
#.........###.##......##.#..#..........#
#.........#.#.#........................#
#.........#...#.#..........#...........#
#.........#...#....#...................#
#.........###.#.#.....................##
#..........#...............#...........#
##.....................................#
#.........................#............#
#..............#.......................#
#................#.....................#
#...................................#..#
########################################
