########################################
#......#..........................#....#
#......##..............................#
#.............#...#.......#....#.......#
#...#.....................#........#...#
#....................#.................#
#.........................#............#
#.....................................##
#..........##...........#..............#
#......................................#
#......................................#
##.......#................#............#
#...............................##.....#
#............#............#..#..#......#
#...........#...................#......#
#...............................#.....##
#......................#........#......#
#..............................##......#
#..#.#..........................#......#
#...............................#......#
#.......#............#..........#......#
#........##.............#.......#......#
#...#..#...............#........#......#
##........#.##.##................##G...#
#.........#...........#.......#.#......#
#.........#.............##......#......#
#.........######.......S........#......#
#...............................#......#
#..............................##......#
#........##....###.#..#.......#.#......#
#..............#...#...................#
#..............#...#............#......#
#..............#...#............#......#
#......#.......#...#.......#....#......#
##.............#####.........##.#......#
#..#...................................#
#......................................#
#......................................#
#...........#..........................#
########################################
