########################################
##...............#..................#..#
#............................#..#......#
#.#............................#.....#.#
#.......########.##########.##.#.......#
#.......##..#.........................##
#.......##..#.................#........#
#.......#####.......#..#....#..........#
#.......#.......#......................#
#.......#...#..........................#
#....#..#.......#.######..........#....#
#...#...#..............................#
#..#.#..#.........#.........S..........#
#.......#.........#.............#......#
#..#....#.........#####.........#......#
#..#....#................#......#......#
#..#....#......................##...#..#
#..#....#................#...#..#...#..#
#..#....#.......................#......#
#..#....#......##.#.#...........#......#
#..#....#.#....#....#...........#......#
#..#..G.#...........#...........#......#
#..#.#..#..#.###....#...........#......#
#..#....#.....#######...........#......#
#..#....#......#.............#.##......#
#..#.#.#####.###.......#...#.#..#......#
#..#.####.##..............#..#..#..#...#
#..#.#.##.###......######....#..#......#
#..#.#######.......#....#....####......#
#..#....#.###.##...#....#..............#
#..#...######..#........#.......#......#
#..##...#...#..#...#.####..#....#...#..#
#..#........#..#................#......#
#..#........##.#.................##....#
#..#...................................#
#......................................#
#.........................#....#.......#
#..............#.......#...............#
#..........................#........#..#
########################################
