########################################
#.....................#...............##
#..........#...........................#
#..........#..####.....................#
#................#...............#.....#
#....G#..........#.............#.......#
#............##..#........#............#
#.............#..##.............#......#
######################.#####.#.........#
#....................................#.#
#.#.#.#..................#.............#
#.#...#....................#...........#
#.#...#....................#.....###...#
#.#...#....#...........#............#..#
#.#####................................#
#............................#.........#
#...................#...............#..#
#...................................#..#
#...................................#..#
#......S............................#..#
#...............#.#.................#..#
#...........#................#......#..#
#......................#............#..#
#...................................#..#
#...................................#..#
#........................#..........#..#
#..........................#........#..#
##..................................#..#
#...#..............#...................#
#.....................................##
#..................................#...#
#......................................#
#.........#..#.......#..............#..#
#.#...#...............................##
#........................#.............#
#..#...................................#
#...##........#.##...#...........#.....#
#.......#............#.........#.......#
#....#......................#..........#
########################################
