########################################
##..........................#..........#
#.#....................................#
#.....................................##
#..........#..#.....................#..#
#......................................#
#....................#......#..........#
#....#.....#.....................#.....#
#...............#......................#
#..#...#...............................#
#......................................#
#...................#..................#
#.....#................................#
#..............................#.......#
#...###########.#####################..#
#...............#......................#
#...#..............#..#................#
#.#..#..................#..............#
#....#............................#...##
#.#..#.................................#
#.#..#...........................#.....#
#.#..#..............#..................#
#.####.###...#######.#########.........#
#........#.........#...................#
#........##..........#.............#...#
#........#...................#.........#
#....##.##.............................#
#.....#................................#
#....#....S............................#
#....##########################........#
#....................................#.#
#.......#...#.................#.#......#
#................................#.....#
#........................#.....#.......#
#......#............#..................#
#...............#.....................##
#...#.............................##...#
#.................#..#.................#
#......................G...............#
########################################
