########################################
#...............#..........#...........#
#.....#................................#
#............#.......#......#..........#
#......#............#..................#
#....................#...........#.....#
#......................................#
#..............#..#......#....#........#
#..........#...........................#
#......................................#
#...##..............#......#...........#
#...........#..........................#
#...........#.................#........#
#.....#.....#................#.........#
#...........#.......#...............#..#
#...........#...#..........#...........#
#...........#.......#..................#
#...........#......#.....#.#.#.........#
#...........#.................#........#
#...........#...########.#....#........#
#...........#.....#....#......#........#
#..########.#######################...##
#...........#....S#....................#
#...........#.....####.#.............#.#
##.....G....#..........................#
#...........#...................#......#
#...........#...............###........#
#..........##...#......................#
#...........#..........................#
#...........######.....................#
#.....#.....#....#......#..........#...#
#............#...##................#...#
#...........##...#............#........#
#...........#....#.....................#
#...........###.##..........#..........#
#......#....#..........................#
#.....#..........#.....................#
#....................#.......#.........#
#.#....................................#
########################################
