########################################
#......................................#
#......................................#
#.#...#................................#
#..#.............#.........#...........#
#.........#........#...................#
#......................................#
#..#.......................#...........#
#...#.....................#.....#......#
#..................................#...#
#..............................#....#..#
#....................#...#.............#
#.........................#............#
#...............#......................#
#............#.........................#
#..........#...........................#
#...............................#.....##
#..............................#.......#
#..........#...###.....................#
#..............#..#.G.....#..........#.#
#..........#...#..#.#.............#....#
#.........#....#..#........#...........#
#..............#..#..............#.....#
#..............#..#....................#
#..............................##......#
#.........#.##############.#########...#
#...........#......................#...#
#...............#.............#....#...#
#.............................#....#...#
#..........#####################.#.#...#
#.........#...................######...#
#................#.###.##..............#
#....#.....#........#...#..............#
#...................#...##.............#
#..............#....#...#..............#
#...................#...............##.#
#...................###S###..#.........#
#..................###.................#
#......................................#
########################################
