########################################
#........................#.............#
#...#...............................#..#
#......#...............................#
#........#..#...................##.#...#
#.........#...............#............#
#........#......................#......#
#.######.#..........#...........#......#
#.#...####...........#..........#......#
#.#...##.#.#.........#..........#......#
#.#..###.#........#..#..........#......#
#.####.#.#...........#..........#......#
#....#...##..........#......#...#......#
#.....##.#...........#..#.......#......#
#........#..................#...#......#
#...S.#.###......#...#......#...#......#
#........#...........#......#...#......#
#........#...........#......#...#......#
##..#..###...........#......##..#......#
#.....#..#...........#....#.##.##......#
#.....#..#........#.......#.#..##......#
#.....#..#..........##...##.#...##.....#
#.....#..#...........#....#.#..###.....#
#.....######.........#....##.####...#..#
#.....#.##..#...............#...#......#
#...#.#..#...........#......#...#......#
#....#######.#.......#.#....#######....#
#........#...........#......##..#...#..#
#.....#.##..................##..#......#
#........#...........#.......#..#......#
#..#....##...........#..G....#.##......#
#..#..#.#............#.......######....#
#.##....#............#..........#......#
#..#....#....#.........#........#...#..#
#..######..............................#
#...#.......#..........................#
#......................................#
#......................................#
#......................................#
########################################
