########################################
#.........................#............#
#........#............#................#
#........................#..##.#..#....#
#...................#...##..#.##.......#
#..........#..#.....#....#..#.##.......#
#............G...........#..####..#....#
#........................#....#........#
#.....#..................######........#
#......................................#
#......................................#
#..........#...........................#
#..............#...........#........#..#
#........#.............................#
#......................................#
#........#.##.............#............#
#........#.##..........................#
#........#..............#....#.........#
#........#..#..#.......................#
#........##.#..........................#
#........#.......#.........#...........#
#..#.......#...................#.......#
#..############################.#......#
#......................................#
#......................................#
#..............#.......................#
##.....#...............................#
#.....................#.......#........#
#..................#....#.#............#
#......................#...............#
#......................................#
#....................................#.#
#...........#####...#..................#
#...........#........S.................#
#...........#..#.......................#
#...........#####......................#
#.................#....................#
#....#.................................#
#...............................#......#
########################################
