########################################
#............................#.........#
#............................#.........#
#..##...#......#..........#.........#..#
#..............#.......................#
#..............#...............#.......#
#..............#.....#.................#
#..............#.......................#
#..............#.......................#
#..............#....#..............#...#
#..............#.............#.........#
#.....#........#.................#.....#
#........#.....#.#.....................#
#..............#.......................#
#..............#.#...........#.........#
#.........#....#.......................#
##............##.......................#
#..S...........#...............#.......#
#..............#................G......#
#..............#.......................#
#..............#..................#....#
#..............#.#.....#.....#.........#
#.......#......#.......................#
#..............#.......................#
#..............##.............#..#.#...#
#..............#.......................#
#..........#...#.......................#
#....######....#######.....#...........#
#....#....#....##....##................#
#....#....#....##....#.................#
#....####.#....#.###.#........#........#
#.......#..................#...........#
#...........#...............#..........#
#..............#.......................#
#...................#..................#
#..............................#.....#.#
#...............................#......#
#......................................#
#..#.........#..................#......#
########################################
