########################################
#................#..................#..#
#...................#..#...............#
#.......#........#...##................#
#......................................#
##............#........................#
#......................................#
#..............................#.......#
#....#........................#...#....#
#.....#................................#
##...................S........#..#..#..#
#...#..#...............................#
#......................................#
#......#........#.............#........#
#......................................#
#.#....................................#
#......................................#
#...............#......................#
#.............#........................#
#......................................#
#........................#.............#
#........#............#.......#........#
#..........#.#..#......................#
#.#..........#.........................#
#....#####..........#........#..#......#
#....#...#..........#........##.#......#
#....#...#...................#..#......#
#....#...#.............#.....#..##.....#
#.....###############################..#
#................#....##......#...#....#
#......................#......#...#....#
#......................#..##...#..#....#
#................#.....#........#.#....#
#......................#####......#....#
#.................G....................#
#......................................#
#......................................#
#....#.......#...............#.........#
#.............#......#..##.............#
########################################
