########################################
#....#.................................#
#......#........#......................#
#..........#...........................#
#..#.###.#.............................#
#....#..##.............................#
#.#.#....#......#......................#
#....#####.............................#
#......................##..............#
#...............................#......#
#......................................#
#......#...........#.G#................#
#....................................#.#
#......................................#
#......................................#
#...............#..............#.......#
#.......#..............................#
#.#....................................#
#......................................#
#..................#.....#.............#
#..............................#.......#
#...........................#..........#
#..#............................#.....##
#......................................#
#..........................#...........#
#....#........################.........#
#......................................#
#.....#..........####..................#
#...................#..................#
#................#..#..................#
#..........#.....####..................#
#....................#..######.........#
#....#############################.#...#
#.......................#....#........##
#............................#.........#
#................#......#....#.........#
#.....#.................#....#.#.......#
#........................#......#......#
#.#......................S.............#
########################################
