########################################
#...#.....................#............#
#.................................#....#
#...................................#..#
#......................................#
#.....#.#........#.....................#
#........................#.......#.....#
#..#.......#......#####...............##
#..##.............#...#....#...........#
#..#..................#...............##
#.##..............#...#...#............#
#..#.......#...########................#
##.#............#.#.##.................#
#..##...........###..#.................#
#..##...........#.#.##.................#
#..#.......#...........................#
#..#...G.......................####....#
#..#.....###...........................#
#..#....#.........................#....#
#..#....#......................####....#
#..#....####.............#.............#
#..#...#.###############.####.........##
#..#####...............................#
#..#####.........#...........#.........#
#..#..##........................#......#
#..#..##...............................#
#..#..#........####...#................#
#..####.......#...#...............#...##
#..#..#....#.S.#..#....#...............#
##.#...........#..#....................#
#..#...........####..#........######...#
#..#.......#.....................#.###.#
#..................................#...#
#......#...#.......................#...#
#.#...........................######...#
#..#...................................#
#.........................#.......#....#
#......................#.......#...#...#
#..............##......................#
########################################
