########################################
#...............................#......#
#...................................#..#
#........#..............#..............#
#..........#...................#.......#
#..............#.......................#
##........#........#.#.....#...........#
#....................#...........#.....#
#.....#...#..........#...........#.#...#
##......#............#..........#.....##
#....................#......#..........#
#....................#.................#
#.......#............#.................#
#..#...#...#.........#..........#......#
#....................#.................#
#..#..##############..##########...#...#
#........#...........#..#.##.#.........#
##.................#.#..#..#...........#
#....#.#..#..........#S.#..#....#......#
#..........#.......#.#.##..#...........#
#....................#..#..#...........#
#..........#.........#...###...........#
#........#....#.#....#.#...............#
#.#....#G............#.................#
#...............#....#.................#
#....................#.................#
#.....#.#########.#####.###.#...#......#
#....................#.......#.##......#
#............................#..#...#..#
#............................#..#......#
#............................##.#......#
#............................#..#.....##
#............................####......#
#................#.....................#
#.....#.................#..............#
#..............#.........#.............#
#...............#......................#
#......................................#
#.........#...#.#............#.........#
########################################
