########################################
#....#.#.......................#.......#
#.........#............................#
#.........#..............#..#..........#
#....##############################.#..#
#......#....................#..........#
#.................#.###..#..#..........#
#..........S......#...#..##.#..........#
#..#..............#...#..#..#..........#
#........#........##..#.....#..........#
#.........#.......#####..#..#..........#
#........................#..##.........#
#......#...........#.....#.##..........#
#...........#..#.........##.#..#.......#
#..##.#.#................#.##..#.......#
#..#..#...#..............#.##..#.......#
#..#..#....#.............#######.......#
#..#.##..................#.##..#####...#
#..###..........#........#.##..#.......#
#........................#.##..#...#...#
##.......................#.##..#...#...#
#...#...........####.#...########..#...#
#......#......#......#...#.##..#..##...#
#...............#..#.#...#.##..##......#
#...............#....#...#.#...##......#
#..........#....#.####...#.######G.....#
#...............#..#.....#.##..#.......#
#.......#................#..##.#.......#
#........................#.#...#.......#
#........................#.##..#.......#
#...#....................#.##..#....##.#
#...#....................#.##..........#
#....#...................#.##..........#
#....#...................#.#...........#
#........................#...#...#.....#
#.......................##.............#
#.........#...#.#.....................##
#......................#.#.#...........#
##.....................................#
########################################
