########################################
#..................#...................#
#..................#...................#
#..............#.......................#
#.....................................##
#.........#............................#
#.........#......#.....................#
#.................#..#.................#
#....#...#.......##..#.......#.........#
#................#...#...#.............#
#.................####.........#.......#
#......#.........#...........########..#
#..#........#.##.#...........#.#..#.#..#
#...........#..#.#.........#.#.#....#..#
#.#####........#.#...........#.#....#..#
#.#.........######......#....######....#
#.#.........#....#..............#......#
#.#####.....#...##....................##
#...........######.#.............#.....#
#...G............##................S...#
#................#...............#..##.#
#...........##...#....#....#...........#
#................#.....#...............#
#.........#......#..............######.#
#.........#......#..............#......#
#....####.#......#..............#...#..#
#.#.......#......#..................#..#
#...##....#......#.....#.......##...#..#
#.........#......#......#...##...####..#
#.........#......#.......#..##..##.....#
#....######......#.#........##..##.....#
#..........#..#.............######.....#
#................#...........#####.....#
#............#...#.....#.....#.........#
#...#............#....#................#
#................#.....................#
#................#...#............#...##
#.#..............#.....................#
#......................................#
########################################
