########################################
#....#..........##............#....#...#
#....................S.................#
##.................#............#......#
#......#...#..#.............#..........#
#......................................#
##........................#.#......#...#
#.....................#................#
#...##################################.#
#.........................####....#....#
#.........#...........#...#..#.........#
#.........#####...........#..#.........#
#.......#.###############..####.....#..#
#..######..#..#...........####...#.....#
#.#...#...##..#..#.....................#
#.#...#...#####......#...#.......#.....#
#.###.....#......................#..##.#
#.....#...##.##............###.#.#.....#
#.....####.###################.#.#..#..#
##.........#..#..........#.#...#.#.....#
#.............#.........#..##....#.....#
##.........####............#...#.#.....#
#..........................#.###.#....##
#.................#......#.......#.....#
#................G...............#.....#
#..#.............................#.....#
#................................#.....#
#................................##....#
#...###.#.#......................#.....#
#...#...#..................#.....#.....#
#...#..##........................#.....#
#.......#..............................#
#...#...#................#.......#.....#
#...#.###....#...................#.....#
#...........................#....#.....#
#...............#.........#............#
#...........................#..........#
#...............#..................#...#
#...##.................................#
########################################
