########################################
#......................................#
#.#....................................#
#..........#............#..............#
#......................................#
#......................................#
#................#.....#...............#
#....................................#.#
#..........................#...........#
#.......#..............................#
#........#############.#######.#####.#.#
#......................................#
#..............#..#......#.............#
#........................#........#...##
#........................#.#...........#
#.....##.##......G.......#...........###
#.....#..#...............#.............#
#.....#..#......######...#S............#
#....#####.....#.....#...#....#........#
#...............#....#...#.......#.....#
#.....#.........#....#...#.............#
#...............#....#...#............##
#...............######...##..#.#.......#
#........................##....#.......#
#........................##....#.......#
#.........................#.#...#....#.#
#........#......#.....#..##....#.......#
#.............#..........#######.......#
#........................#..#.....#....#
##.........#.............#.............#
#..#........#............#.............#
#.#......................#.............#
#.....#..................#.............#
#........................#.....#.......#
#...........#..........................#
#......................................#
#......................#.........#.....#
#...#.........##...................#...#
##......................#..............#
########################################
