########################################
#.......................#..............#
#......................##..............#
#........................#.............#
#.....................#...............##
#...#...#..............................#
#...#...#...................#..........#
#...#...#..............................#
###.#...#.#.............#..............#
#...#####......#........#..............#
#.......................#..............#
#.#.....................#..............#
#.......................#..............#
#...........#...........#..#.###.......#
#..#....................#..#.#.#.......#
#..#......#........#....#..#...#.......#
#...#.####.#######.######.#.#..#.....#.#
#.......#..............S##.#####.......#
#.......#...#...........#..###.#.......#
#.#.....#####...........#.....#........#
#......#.#.#####.###########.#.#####...#
#.......####.##.........#..#...........#
#.......#....#..........#...........G..#
#.......#....#..........#..............#
#.......#.#...####......#..............#
#....#..#..##.#........##..............#
#.......####.##..#......#..............#
##.........#..#..##....................#
#.............####......#.....#........#
##.........#####........#....#.........#
#.............#.........#.....###.#....#
#........#..#....#......#.....#...#....#
#....................#..#.........#....#
#.....#.................#.....#...#....#
#...............#......##.....#...#..#.#
#.......................##.....####....#
#.....#.......#############.#...#......#
#............................#.........#
#.....#................................#
########################################
