########################################
#......................................#
#.........#............................#
#.......#........#.....................#
#......................................#
#...#..............#...................#
#......................................#
#....#......................#..........#
#......................................#
#..........................#...........#
#......#...............................#
#....#.........................#.#.....#
#.........#............................#
#....#.....................#......#....#
#.........#.####...#...................#
#...G.......#.........................##
#...........#...#...#.......#.......#..#
#....#..######.###############.#.......#
#......#......................#........#
#.######......#....................#...#
###....................#............#..#
#.#....#..............#.....#..........#
#.######.......#...............#.......#
#.............#........................#
#..............#........##.............#
#..####.##############.#####...........#
##.....................................#
#....#...#.............................#
#......................#.......#..#....#
#....S.................#....#..........#
#...........#.....................#....#
#...............#......................#
#......................................#
#........#.............................#
#....................#.................#
#....................................#.#
#.................................#....#
#....#..........................#......#
#..........................#...........#
########################################
