########################################
#...............#......................#
#......................................#
#....................##................#
#......#.#.....................#......##
#...............####...................#
#.#.............##.#...................#
#...............#..#.##................#
#...............#..#..#................#
#...............#..#..................##
#...............##.#...#...#...........#
#...........#...#......................#
#......................................#
#........#............................##
#......#.............##................#
#.....#..............#............#....#
#....................#.................#
#..............#.....#......#..........#
#....................#.................#
#................#...#.................#
#....................##........G.......#
#...#................#.##..............#
#...#.....#......S...#.................#
#....................#........#........#
#...............#....#.##..............#
#....................#.#..#............#
#.............##.....#.#..#............#
#......#.........#.....#..#............#
#....................#.#..#............#
#....................#..###............#
#.................#....................#
#......................................#
#...........#..........................#
#..............................##......#
#...................................#..#
#.................................#....#
#......#...............................#
#.......................#..............#
#.#.....#..................#.....#.....#
########################################
