########################################
#....................#.................#
#......................#...............#
#.............#..........#....#........#
#......................................#
#..#.............................#.....#
#................................#.....#
#............................#...#.....#
#.......#..#...............G.....#.....#
#................................#...S.#
#......##############.#############....#
##........................#......#.....#
#........#...............##......#.....#
#.........#...............#......#.....#
#.......#.................##.#...#.....#
#...............#.........#.####.#.....#
#.........................#.#..#....#..#
#......................#..#.#..#.#..#..#
#.........................#.#....#.....#
#........#.....#.........#######.#.....#
#........................##...#..#.....#
#........................##.#.#..#.....#
#....................#...##...#..#.#...#
#........................##...#..#.....#
#........................##....#.#.....#
#......................#..#......#....##
#.........................#......#.....#
#................#......#.#......#..#..#
#.#.......................#......#.....#
#.................#.......#............#
#.......................#.#......#....##
#................#......#.#.#..........#
#.........................#............#
#.........................#.#..........#
#.........................#............#
#......................#...............#
#........#....................#........#
#................................#.....#
#..................#.........#........##
########################################
