########################################
#....#.........#.......................#
#................#.....................#
#.....................#......#.........#
#..............#.......#.#.##.#........#
#.....#................#....#..........#
#......................#....#..........#
#..........#...........######.......#..#
#......................#...............#
#......................#...............#
#........#.#.....#.....#..#...#..#.....#
#......................##...#..........#
#......#...............#...........#...#
#......................#....#..........#
##............S........#......G......#.#
#............#.........#...............#
#.............#........#........#......#
#......................#...............#
#......................#...............#
#...#.......#..........#.........#.#...#
#...........##.........#..............##
#......................#.............#.#
#....#.................#...............#
#......................#...#...........#
#...##.................#.....#.........#
#......................#..............##
#......................#...............#
#....................#.#...............#
#....................#.#...............#
#......................#...............#
#......................#.........#...#.#
#......................#..............##
#............##.###########..#.........#
##.....................#..#..##........#
#......................#...............#
#......................#...............#
#..##..................................#
##....#.....................#..........#
#.....#...................#....#.....#.#
########################################
