########################################
#.#..........................#.........#
#..................#...................#
#..##............................#....##
#...#.....#........#..#.........#.#....#
#...######.............................#
#...#....#............#....#...........#
#...#.#.##..#################...#......#
#...####.#......#...G...#####..##......#
#...#..####.....#.......#..######......#
#...#..#..#.....#.....#######..#.......#
#...#..#..#..#..#.....#.#####..#.......#
#...#..#........#.....#....#####.......#
#...#...###.....#....##....##..........#
#...#......#######..########.####......#
#...#...........##.#..#...#..........#.#
#...##..S.......#...............#......#
#...#...........#......................#
#...#...........#..#...................#
#...#........#..#......#.#.............#
#...##..........#......................#
#...##.....#.####################......#
#...#...........##.....................#
#...#.#.#......##......................#
#...#........#..#......................#
#...#...........#.#.......#............#
#...#...........#......................#
#.............#.#......................#
##..#.....................#####........#
#..#............#.........#...#....#...#
#...#.....................#...#........#
#........................#....#...#....#
#..#..........................#........#
#............#............#####........#
#......................................#
#...#....................#.............#
#...............#................#.....#
#................#.....................#
#.....##...................#...........#
########################################
