########################################
#....................................#.#
#.........#######....##................#
#..............##.............#..#.....#
#............#.##......................#
#....####.#######.#....................#
##.#....#.......#......................#
#..#....#..#....#S..........#..........#
#..######.......#......#...............#
#.#.............#.......#.#......##....#
#........#......#......................#
#...............................#......#
#...............#...#.#................#
#...........#..##...#.#.............##.#
#...#..######...#...#.#................#
#......#....#...#...#.#................#
#.......#.####..#####.#....#...........#
#.......#..####################.#......#
#......##...##..#.....#...######.......#
#....#..##################.###########.#
#.......#.......#.....#....#.#.#....#..#
#.......######..#.....#...........#....#
#...............#.....#......#.#.......#
#...............#.....#...####.#.......#
#...............#.....#................#
#..#..##........#.....#............#...#
#..#.#.#####.#####.#########.########..#
#..#...#.#....#.#.....#................#
#..#...#........#.....#................#
#..#...#....#...#.....#......#.........#
#.##.##########################.#......#
#.#....#....#.........#................#
#.##....#.............#................#
#.##...##............................#.#
##.#....#.............#......#.....#...#
#...#####.............#.......#......#.#
#.......#...........................#..#
#.......#...................#......#...#
#...........#.#..........G.......#...#.#
########################################
