########################################
#......................................#
#.................#....................#
#......#.............#.............#...#
#......#...#................#..........#
#......#........#......#........#......#
#......#.#..............#..............#
#......##..............................#
##.....#...................#...........#
#....................................###
#......#.........#...#.................#
#......#.........#...#.................#
#......#.........#...##....#..........##
#......#.........#...##....#...........#
#..............#.#...##................#
#......#.........######....#...........#
#......#..............#....#.....#.....#
#......#..............######...........#
#......#.............#.................#
#......#...............................#
#......#..####################.#.#....##
#......#.#.........#..............#...##
#.....S#...............................#
#......#...............................#
#......#..........G.....#..............#
#.#....#...............................#
#......#..........#..................###
#......#............##.................#
#....#.#.....................#####.....#
#......#.....................#...#.##..#
#................................#.....#
#......#...........##........##.##.....#
#......#.......#.......................#
##.....#................#..............#
#.#....................................#
#..............#......................##
#...#..........#..#.....#..............#
#......#.......#....#..............#...#
#............................#.........#
########################################
