########################################
#......................................#
#......................................#
#.................#..#.................#
#............#.........................#
#.#...#................................#
##..........#...............#.#........#
#.......####..#......#.................#
#......##..#...........#.......#.......#
#...#...#######........................#
#.......#..#..#........................#
#.....#.#..#..#..######................#
#....#..#.##.##.....#######............#
#..S........##....G.#.#..#.............#
#............#......#.#..#....######...#
#............#......#.#..##.....#..#...#
#............#...######..#......#......#
#............#..................#..#...#
#............#..........#...########...#
#............#.................##.###..#
#............#..............#..#.......#
#......#######..............#..#.#.....#
#......#.....#..............#..#.....#.#
#......#....##..............####..#....#
#....#.#....##.....#...#...............#
#..######...##.........................#
#..#...#######................##.......#
#....##########.###.############.......#
#..######....#................#........#
#.......#.#............####...####.....#
#.......######.........#...............#
#......................#...............#
#..#.........#........##...............#
#......###########################.#...#
#.....#................####.....#......#
#................##....................#
#......................................#
#.......#....#.........................#
#......................................#
########################################
