########################################
#......................................#
#......................................#
#.........#................#...........#
#...........#..........................#
#..............#.......................#
#...#...............#.#..#.............#
#...................##.................#
#...................#..................#
#........#..........##.............#..##
#.....................................##
#.#.................#..................#
#...................#.......#..........#
#....#..............#............#.....#
#...................#..................#
#............#......#..............#...#
#.............#.....#....#.............#
#...................#..................#
#...................#............#.....#
#...................#............#..#..#
#...#...............#.................##
#......#............#..........G.......#
#.....#...#.........#..................#
#.....#............######.........#....#
#...................#..#........##..#..#
#.#.................#..#...............#
#.#..................#.#...#...........#
#...................##.#...............#
#.....S...#####....#####...............#
#.####.....#..#.....##....#............#
#.#........#..#.....#....#...#.#..#...##
#.#........#..#.#...#..........#..#....#
#.####.....#..#.....#..........#..#....#
#...................#..........###.#...#
#....#.#............#..................#
#.........#.........#..##..............#
#...#................................#.#
#.....#...#...#.....#..................#
#..................#...................#
########################################
