########################################
#........#.............................#
#..#..............#.###.......#####....#
#........#........#...#.......#........#
#.................#...#..#....#........#
#.................#...#..#....#.#..#...#
#....#............#####..#....#........#
#........................#....#####....#
#...............#..#.....#.............#
#...#.................#..#.............#
#...........#............#.............#
#........................#.............#
#........................#.............#
#........................#.............#
#..........#...#.........#.#......S....#
#..#......#..............#.............#
#.....#..................#.............#
#.......G#............#..#...#.........#
#........................#.............#
#........................#.............#
#.......#................#.............#
#....................#...#.......#.....#
#...............#........#.............#
#........#............#..#####.........#
#..................#.....#...#..#.#....#
#.#....#...........#.....#...#.........#
#...#....................#...#.........#
#.#.......................#######......#
#..#............#.#......#.#....#.#....#
#..........................#....#......#
#................#.........#....#......#
#.........#................#....#......#
#...#......................#.####......#
#.............#....................#.#.#
#......................................#
#..#...................................#
#...............................#......#
#.....................#...#............#
#............##......#.................#
########################################
