########################################
#...............#......................#
#..............#...#...................#
#..........#.....#.....................#
##.........#.....#.....................#
#...#.#######..#################.#.....#
#......####...............##...........#
#.........#.#..#...........#.......#...#
#.........#.#..............#..#........#
#.........#.#............#.#..........##
#.........#.#.......#......#...........#
#......####.#........#.....#...........#
#........#..#.....#........#.....#.....#
#...........#..............#...........#
##..........#....#.........#...###.#.#.#
#...........#...........#..#...#..##...#
#.######....#.#............#...#...#.###
#.#.....#####............#.#...#...##..#
#.#....####................##...####...#
#.########..#..............#...........#
#......##...#...........#..#...........#
#......######..............#...........#
#.......#..................#.........#.#
#...........#....#.......#.#........#..#
#...........#..............#..#........#
#.....#.....#..............#...........#
#.#...#.....#.#...........##...........#
#...........#...########...#...........#
#...........#.....##.......S...........#
#...........#.....##...................#
#....G#.....#...#.##..#......#.........#
#.........#####.#..#.....####..........#
#.........#.....##.#####....#..........#
#....#....#..................#.........#
#.........#........#.....##.#..........#
#.........#.................#....#.....#
#.........#####....#.....####..........#
#...........#..........................#
#.....#................................#
########################################
