########################################
##........#.......#..#.................#
#.................#...............##...#
#...#...............#..................#
#.........#.........###.#..............#
#..#................#...#...#..........#
#..................##...#..............#
#........#..........#...#..............#
#...................#...#........#.....#
#................#..###.#..............#
#...............#...#..................#
#.................#.#.........#........#
#...................#...#....#.........#
#..#.......###......#..................#
#..........#..##...##..................#
#..........#...##...#..................#
#.....#....#...#....#..................#
#..........#..##....#.........###......#
#.G.................#.........####.....#
#...................#.........#......#.#
#...................#....S..#.#..#.....#
#.........#.........#.#.......#..#.....#
#.........#.........#.#........#....#..#
#..........#........#..................#
#.............#.....#..................#
#.......#.##........#............#.....#
#.....#.............#...............#..#
#...............#...#....#.............#
#...................#....#..#..........#
#.................#....................#
#...#....#.............................#
#..#..........#..................#.....#
#....................#.................#
#.................................#....#
#.....................#................#
#....................................#.#
#.#.........................##.........#
#...........................#.......#.##
#...#..................................#
########################################
