########################################
#...........#.....................#....#
#......#...............................#
#......#..........G.................#..#
#......#...#...........................#
#....##.######.#####################...#
#......#...#..##.#.....................#
#......#...#..###......................#
#....#.#...#.####......#...............#
#......#...######......................#
#......#......####.....#.............#.#
##.....#.......#.......................#
#.....##.......#.......................#
#......##....#.#.......#......#..#.....#
#.#....#..########################.#...#
#......#.......#.......#.....#.........#
#......#.......##....####.#..#.........#
#......#......##.....#.#######.........#
#.#....#.............#.####.###........#
#......#.......#.....#.#.#####.........#
#......#...#####.##############........#
#..#...#.......#.......#.#..#..#.......#
#......#.......#......##...........#...#
#......#.#.....#.......#...............#
#......#..#....#.......#...............#
#......#.......##......#...........#...#
#.#....#......##...#...#...............#
#..#...#....#.##.......#.............#.#
#.....####....##.......##.#............#
#.....##..#.#..#...#...#..######.......#
#.....##..##...##......##.#..#.#.......#
#.....#####....#.....#.#.S#....#.......#
#......#.......#...#...#.......#.......#
#......#.....#.#.......#..#....#......##
#..............#.......#..##.#.#.......#
#......#..............##...#...........#
#......................#...............#
#............#.........................#
#......................................#
########################################
