########################################
#.....#.........#..................#...#
#..................................#...#
#..........####.##################.....#
#........#.............#.....###.#...#.#
#........#............#......#...#.....#
#.....................#......#...#..#..#
#.............G.......##.....#...#.....#
#.....................#....#.#####.#...#
##....#...#..#........#......#.........#
#............#........#................#
#....##.##...#....#.#.#................#
#........#...#........#......#.#.......#
#....#.##########.################.....#
##.......#...#........#......#..##..#..#
#....#####...#........#......####......#
#.#......#...#........#................#
#...#........#........#................#
#............#........#................#
#............#........#..#.............#
##...........##.......#................#
#............#.......######............#
#............#........##.##........#...#
#............##.......##.##............#
#......#..#..#......#######............#
#.##########################.#...#.....#
#......#..##.#.############.#####...#..#
#......##.#..#........#................#
#........#...#........#................#
#............#........#.........#....#.#
#....#.......#....#...#................#
#............#........#..####....#.....#
#............#........#..#..#..........#
#...........##...........#...........#.#
#...........##.......##..#..#..........#
#............#......S.#.....#..........#
#........................#..#.......#..#
#.....#......................#.#.......#
#.........................#............#
########################################
