########################################
#...................................#..#
#......................................#
#....#.................................#
#...........####...#...#.....#....#..#.#
#...........#..#............#..........#
#...........#..#.......................#
#..............#.######................#
##...............#..##.................#
#................#..#..##..............#
#............#...####..............#...#
#................#..#..................#
#.......#...#...#######................#
#.#.....#...#.......#..............#...#
#.......#...#.#...#.#..................#
#.......#####.......#..................#
#....................#.................#
#......#.........#..#.......#..........#
#......#...#......#.#..................#
#...#...............#.#.....#..G.....#.#
#...................######........#....#
#.......#...........#....#.............#
#......##..S........#....##....#.......#
#.......#...........##.###.............#
#...................#..................#
#...................#....#.............#
##..........#.......#.#................#
#.............#.....#..................#
#.........#.........#....#.............#
#........####.#..#.####...#............#
#....#....#...#..#..#.#................#
#.........#...#..#....#................#
#.......#####.#.......#.......#........#
#.........#.#.#..######................#
#....##.############################...#
#........####..........................#
#.#................#......#............#
#..#...................................#
#......................................#
########################################
