########################################
#..#.....................#..S..........#
#.....................................##
#...#.................######...........#
#.......#.....#.......#..##.#.##....#..#
#.................#...#..#.#..#........#
#...#.........#.....#.#..#.#..#........#
#.....................#..#.##.#........#
#.....................#..#.####........#
#.......###############.##########.#...#
#...............#......................#
#...................#...#..............#
#................#.....................#
#.......#......................#.......#
#..#...................................#
#.......#.............G................#
#...........................#..........#
#....................................#.#
#......................................#
#......................................#
#......................................#
#......................................#
#......................................#
#...#..................................#
##.....................................#
#...#.....#.................##....#....#
#......#......#......................#.#
#...#............................#.....#
#.........#......#.....#.............#.#
#......................................#
#...........................#..........#
#.......#.......#.............#........#
#......................................#
#..........#..........#...#..#.........#
#..#.#.................................#
#....#.................#...............#
#...............................#......#
#......................................#
#.......................#..............#
########################################
