########################################
#................#.....................#
#......................................#
#....#########S###.#############.......#
#................#........#............#
#.........................#...........##
#......................####.G..........#
#.......########################.#.....#
#.......#.........#....................#
#.................####....#............#
#.....######.##.##...#.................#
#.......#..#.....###.##....#...#.......#
#.....#....#.....###.#..............#..#
#..........#.#####..#......#..#........#
#.....##..##....#######.......#........#
#...........#.............#...######...#
#.............................#.#......#
#.....#.......#......#.....#..#....#...#
#..#......######..........#...#....#...#
#.........#...........#####...#.####...#
#.........#...........#...#............#
#.......#.#.####......#...#............#
#.....................#...#............#
#..............#......#...#............#
#...#..................................#
#........#........#........#..#........#
#.........#........#....#..............#
#......................................#
#.....................#.........#......#
#..............#####...................#
#...#..........#..##......#####..#.....#
#.....#........#...#......#...#........#
#..............#...#......#............#
#......##......#..........#...#........#
#..............#.###......#...#........#
#.........................#...##.......#
#........#.............................#
#.#......#.............................#
#................#.....................#
########################################
