########################################
#..#....#............................#.#
#....#......................#..........#
#......................................#
#.....#....................#...#.......#
#.....#........#...#...................#
#....####..............................#
#.....#...................#............#
#....##.#................#.........#...#
#....##.#...................#.#........#
#....##.##...............##...#....#.#.#
#....####...........#....##...#........#
#........................#....#...#....#
#.....#..................#....#........#
#.....#......#..#####....#....#........#
#..####..................##...#........#
#..#..#.......#.#.#.#..#.#....#......#.#
#..#..#.........#####....#....#..#.....#
#..#..#..........#.......#....#........#
##.#..#.#####################.#........#
#..#...........#.........#....#..#.....#
#....##....######.###########.#........#
#.....#..................#....#....#...#
#.....#..............#...#....#....G...#
#.....#..................#...##...#....#
#.....#.......##.#.......#..####..#....#
#.....#.......#..#.......#...##...#....#
#...#.#.......#..#.######..#.######....#
#..#..#.......#..#.#.....#....#........#
#.....#......S#..#.#.....#.............#
#.....#.......######...#.#.............#
#.....#............#.....#.............#
#.....#............#######.............#
#...#.#..................#.............#
#.....##.................##..#........##
#.....#...............#..#....#........#
#.....#..................#.............#
#......................................#
#........#.........................#...#
########################################
