########################################
#......................................#
#.#..................................#.#
#......................................#
#......................................#
#.........................#............#
#.....#................................#
#......................................#
###................#...................#
#.............#........................#
#........#.......#.....................#
#......................................#
#......................................#
#.....#................................#
#.....#................................#
#..##G#.#....................#...#.....#
#.....#.........S....#.................#
#.....##..........................#....#
#.....#...#..........#..........#......#
#.....#.......................#........#
##....#.........................#.##...#
#.....#..............#.................#
##....#..#.............................#
#.....#................................#
#.#..##......#....#...................##
#.....#...######.......................#
##....#...##...........#...#...........#
#.....#...##...#......#......#.........#
#...##################.#####...........#
#......####............................#
#.........#............................#
#.....................#......#.........#
#.............#........................#
#..........................#.#.........#
#......................##.#............#
#........#.###########.######..........#
#............................#...#.....#
#.....#..................#.........#...#
#...................#..................#
########################################
