########################################
#......................................#
#.............#....#...................#
#........#.####.#......................#
#.......#.#####.########..########.....#
#.........##....#.#.###.....#...##.....#
#...###.#..######.#...#.....#.#.#......#
#.......#.........#...#.#...#####...#..#
#....#..#.........#...#..#.##...#......#
#.......#....#....#...#..#S######..#...#
#.......#.........#####..#..#..........#
#...####.................#..#........#.#
#........................####..........#
#..................G.#.............#...#
#..#.##################.#####..........#
#......................#...............#
##.....#.......................#.......#
#.#........#...#......#.......#........#
#..........#...#...#.....#.............#
#..........#..##.......................#
#..........#...#.......#..............##
#...#...#.######..........#.#####......#
#.......#...#..............#....#......#
#....#..#...##....#........#...........#
#.......#.####...##........######......#
##...........#.........................#
#............#....#....................#
#............#....#............#.......#
#............###.##.................#..#
#.............####.....................#
#................#.............#.......#
#............##..##..........#.##......#
#.........#....#.#.......#...#..#......#
#.#.#...#.....#..............#..#......#
#.............####...........####......#
#.#.###########.##.#############.......#
#......................................#
#......................................#
#.................#....................#
########################################
