########################################
#......................................#
#......................................#
#......................................#
#......#..................#.#..........#
#......................................#
#...............#......................#
#........................#.............#
#.......#.........................#....#
#......####################............#
#.....#........#.......................#
#.....#..#.##......................#...#
#.....#................................#
#.....#.....#.........................##
#.....#.......................#.#......#
#.....#................................#
#.....#..#............#......#...#.#...#
#.....#............................#S..#
#.....#..............#......#..........#
#..G#.#................................#
#.....#.............................#..#
#.....#............#.#.................#
#.....#....................#...........#
#.....##...............................#
#.....#...........................#....#
#.....#.............#..................#
#.....#................................#
#.....#................................#
#........#...........#...#....#........#
#................##.####...............#
#................#.....................#
#................#....#................#
#.#..............#....#....#........#..#
##...............#....#......#.........#
#................######................#
#............#...................#.....#
#...............................#...#..#
#......................................#
#......................#...............#
########################################
