########################################
#.#...#...........#..#.................#
#...G..................................#
#...#..................................#
#......................................#
#...#.....................##...........#
##..#..................................#
#...#..............................#...#
#...#..###.#...........................#
#......#...#.....#................#....#
#......#.######.........#.....#........#
##..#..######.#...#####................#
#...#....#....##..#...#....#...........#
#...#.........#.......#................#
#...#.....#####.......#....#.......#...#
#.#.#.................................##
#..#############.###############.#...#.#
#...#..........#..#........#...........#
#...#....#......#......................#
#...#########.##.##################....#
#...#.#..#.#S..............#...........#
#...#.#...##...............#...........#
#...#.#....#...............#...........#
#...#.#....#.######........#.......#...#
#...#.#....#......#........#...........#
#...#.............#........#...........#
#...##......####..#........#...........#
#...#.......#.....#........#...........#
#.#.#.......###.###........#...........#
#...#.......#.#............#...........#
#...##......####...........#...........#
#...#................#...#.#...........#
#...#...#.....#............#...........#
#...#.#....................#......#....#
#...#...................#..#...........#
#...#........#........#....#...........#
#...##..............................##.#
#...............#......................#
#..............#....#...#........#.....#
########################################
