########################################
#.....................................##
#..........#...#............#...#......#
#..#####..............####.............#
#..#..............#...G..#.............#
#..#...#..............#..#.............#
#..#####...####.#.....#..#....#........#
#....#.....#....#.....###.#....#....##.#
#........######.#......#..#....#.......#
#.....#..########......#..#....#.......#
##.......##..#....####.#.......#.......#
#........##...#...#..#.#..#....######..#
#........##...#...#....#..#....#.......#
#........######...####...#.....##......#
#.........#.#.###################......#
#.......#.##...................##...#..#
#.........#...............#....###.##..#
#.........#....................#...#...#
#.........#.#..............S...#.......#
#.........##.#...............####......#
#.........#..................#.#.#.....#
#.........#..................#.#.##....#
#......#..#....#.........#####.#..#....#
#.........#.......#......#..##.#.......#
#......#..#..............#..#####......#
#.........#...........#..#..#.....#....#
#.........#..............#.....#.......#
#.........#..............####.##.......#
#...#.....#............#.......#.......#
#.........#..#............#....#.......#
#.........#...........####...#.#...#...#
#..#......#...........#..#.....#.......#
#..#...#..#....#...#..#..#.............#
#.........#...........#..#.##..........#
#.........#.........................#..#
#.........#.......................#....#
#...........#.#........................#
#....#....#............................#
#....#.#.#......#.#................#...#
########################################
