########################################
#.............##.......................#
#...................................#..#
#...........#...............#..........#
#......######..........................#
#......#....#..............#...........#
##.....#....#.#............#.....#.....#
#......#..#.##.......#...........#.....#
#...#..#..#.#...##.............#.#.....#
#......#..#...#..................#.....#
#..#.#........#..................#.....#
#.....#...##.##........................#
##....#.......#......#...........#.....#
#.....#.......#......S#..........#...#.#
#....##....######................#.....#
#.....#....##.#...............#..#.....#
#.....#..#.##.#.#..#.............#.....#
#.....#....#..#.#................#.....#
#..........##.#.#...#............#.....#
#.....##.#.######................#.....#
#..#..#...#...#....#.............##....#
#.....#.......#..................#.....#
#.....#......##..................#.....#
#.....#......##..........#.......#.....#
#.....#.......#.....#..####.#....#.....#
#.....#.#####.#........#....##...#.....#
#.....#######################.#..###.#.#
#.....#.#...#.#........#.####....#.....#
#.....#.#.##..#.............#....##....#
#...#.#......##.........####.....#.....#
#.....###########.#############.#......#
#.....#.......#.....#...#..#...........#
#.....#.....#.#.........#..#...........#
#.#...#.......#.........#..#..........##
#.....#.......#......G..#.##.#.........#
#.....#.......#........................#
#.#...#.....#.............#............#
#.....#........#.#.....................#
#......................................#
########################################
