########################################
#......................................#
#......................................#
#..............#.........#.............#
#......#.##################............#
#..............#.............#.........#
#......#.......#...................#...#
#...........#..#..............#........#
#...........#..#.......................#
#......#....###################........#
#......#..#.#..#.......................#
#...........#..#.......................#
#...........#..#..........#....#.......#
#.........#.#..#...#.......#..........##
#.........#.#..#.......................#
#.....#####.#..#.......................#
#.....#...#####........................#
#..G..#.....#.#####.............#......#
##....#####.#..#...#...................#
#.....###..##..#...##..#.....#.........#
#...#.#.#..###.#....#..#......#........#
#.....#....##.###.###..#...............#
#..#..###.#####################........#
#.....##.#....##.#.#..................##
#..#........#.##.#.....S...............#
#...........#.####.....................#
#...........#..#........#..............#
#..............#.......................#
##......#......#.......................#
#..............#.....#.####............#
#............#.#.....#....##.........#.#
#..............#.....#.................#
#..............#.....#....#.....#......#
#.............######################...#
#....................######...#...#....#
#......................................#
#......................................#
#..................#...................#
#..................##..........#.......#
########################################
