########################################
#...............#......................#
#......................................#
#..............#..................#....#
#........####..........................#
#..#...#.#..#.......######......#......#
#........#..#.##......G..#.............#
#........#..#.....######.#.............#
#...........#.....#.##.#...............#
#........#..#.......#..#.#............##
#.................#.#..#.#.............#
#................##....#....#..........#
#..................#####.##............#
##.....................#...............#
#......................##..............#
#...........#########.#############.#..#
#......................#.............#.#
#........#...........#....###..........#
#......................#..#............#
#......................#..#............#
#....############.###########..........#
#........#.#######.########............#
#............#....#....#..####.........#
#............#.####....#...............#
#......................#...............#
#...#............#.....#........#......#
#...........#....#.....#...........#...#
#..............######..#...............#
#..#....#...#....#..#..#.S.............#
#.......#...######..#..................#
#..............#####...................#
#..............#..............#........#
#......................................#
#.........................#............#
#......................................#
#....#................................##
#......................................#
#......................................#
#..#.....#.............................#
########################################
