########################################
#............#.........................#
#.....##...............................#
#....................#.#...............#
#.....#................#.#....#........#
#.....#....#..#.......#..#.#..#........#
#....##.#######.##.###############.....#
#.....#....#.............#..........#..#
#..........#.........#...#.............#
#.....#....#.............#.............#
#.....#..###.............#.............#
#.....#.#..#.............#.............#
#.....#....#.............#.............#
#.....#....#...#.........#.............#
#..###..S#.#.#....#......###...........#
#..#..#....#...#.........#..#..........#
#.....#....#.............##............#
#.....#....#.....#.......#......#......#
#..####....#.............##..#.........#
#.....#....#.............#.............#
#.....#....#.............########......#
#.....#....#.............##....#.......#
#.....#....#.............##...##.......#
#.....#....#.....##......##....#.......#
#.....#....#..........#..#.............#
#.....#....#.............#.............#
#.....#..####............#.........G...#
#.....#..#.##............#.............#
#...#.#..########.###.############.....#
#..#....############################...#
#........#.##............#....#.#......#
#........####........##.#..#...........#
#..........#.........##.#..#.......#...#
#.#....#.............##.#..#...........#
#...#......#.........##.#..#...........#
#...........#........#####.#..........##
#....................####..............#
#.....................#................#
#......................................#
########################################
