########################################
#............#.........................#
#..#............#.........#..#.........#
#..#.#....#..#............#..#.....#...#
#..###....#......#...#....#..#.........#
#..#.#....#.......#.......####.........#
#..#.#....#...#...#....................#
#..#.######....#.......................#
#..#.....#.............................#
#..#......#............................#
#..#...#.....#.################........#
#..#............#......#............#..#
#..#..#.#######.##.########.#..........#
#..#............#........#..#........#.#
#..##...........#........#..#..........#
#..#.#..........#........#..#..........#
#..............##....#...#..#..........#
#..#............#........##.#..........#
#..#..........#.#......................#
#..#............#.#.......#............#
#..#...................#.....#.........#
#..#........#...#......................#
#.##............#.#................#...#
#..#............#......................#
#..#............#...#....#......#......#
#..#............#...............#......#
#..#...#........#..........#...........#
#..#....####..................G.......##
#..#..###########################......#
#..#..#.###.############.##########.##.#
#..#....#..#................##.........#
##.........#.################.#....#...#
#.......####...........................#
#...#.#.##.#.........#..S.....#........#
#.......#.............................##
#...............#..................#...#
#......................................#
#.........................#............#
#..................................#...#
########################################
