########################################
#.......#..............................#
#.............##..........#...........##
#.#.......................##...........#
#.............#...#.......#..........#.#
#...#..........#..#.......#...........##
##..............#.#......##............#
#..#..............#.......#............#
#................##.......#............#
#.................#.......#............#
#................##....#..#............#
#.............#..##.......#...#..#.#...#
#.............#.#.##......#.#.#....#...#
##........#...#...#.#.....#...#.G..#..##
#.............#..##.#...#.#.#.#....#...#
##............#.#####.....#...######...#
#.............#..##....#.##.#..........#
#....#........#..##......##.#..........#
#.............#..##......##.#..........#
#...#######################.#..........#
#.#...........#..##..#...##.#...#......#
#...#.........#..##......####...#.#....#
#.....#.......#..##.......#.##..#......#
#............##..##.#.....#.#...#......#
#..........#..#..##....#..#.#...#......#
#....#..S...##.####...#...#.#####......#
#....#........#..##.....####...........#
#....#.###.......##....#..##...........#
#....#...#.......#.....#..#............#
#....#...#.#.....##..#.#####..#.......##
#....#...#..#######.......#............#
#....#...#.......##......##............#
#.....####.......##.......#............#
#................##.......#............#
#....#........#...#.......#.....##.....#
#........####.#########...#............#
#.........................#............#
#...#..........................#......##
#......................................#
########################################
