########################################
#..........#...........................#
#.............................#........#
#..................................#...#
#.............#........................#
#...............#......................#
#.......###........................#...#
#........#...........#......#..........#
#.....#.#..............#.........#.....#
##....G.#..............#...............#
#.###########################.####.....#
#.......####.................#.........#
#........#.............................#
#...................................#..#
#....#................#................#
#......................#.............#.#
#..................#...................#
#....#.................................#
#......................................#
#...........#..............#...#.......#
#......#....#......#.#...#.#...........#
#...............#......................#
#.................................#....#
#............................#...#.....#
#......................................#
#......................................#
#........########.....#................#
##...S#..#..#.#.#......#...............#
#........#..#.#.#......................#
##....#..#..#.##############...........#
#.............#.#..........#...........#
##..........#........#.................#
#........#..........#.......#....#.....#
#.........#............................#
#............................#.........#
#...................#..................#
#......#.....................#...#.....#
#......................................#
#......................................#
########################################
