########################################
#....................................#.#
#......................................#
#..#...................................#
#.........#...#........................#
#......................................#
#........#####.........................#
#........#...#....#....................#
#....#...#...........#..............#..#
#........#####.........................#
#.................#....................#
#.#...................#..........#..#..#
#....##................................#
#...#..............#..#.....#.....#....#
#.....#.....#...............#..........#
#...........................#..........#
#.....#######...............#..........#
#...........................#.......#..#
#......#....#...............#..........#
#......#....#..#............#..........#
#......####.#........#......#..........#
#.......................#...#..........#
#.......................#...#.#........#
#.....#..........#..........#..........#
#....#......................##....S....#
#....#...............##.....#..#.......#
#..........................##..........#
#...........................#..........#
#........................######........#
#............#...........#..#.#........#
#........................#..###....#...#
#.....#...............G..#..###.......##
#...........................#.#........#
#........................######........#
#...............#...........#..........#
#..............#............#..........#
#........................#..#.........##
#................#.....................#
#.............................#........#
########################################
