########################################
#.......#...................#.......#..#
#......................#...............#
#.......#.##.########.############.....#
#....##...#................#...........#
#.....#.#.#...........#................#
#.....#...#.........................#..#
#.....#...#.....#....................#.#
#.....#...#...........#................#
##....#...##........##.................#
#.....#...#............................#
#.....#...#.........#..................#
#.....#...#................#...........#
#.S...#...#............................#
#.....#...#...#.#......................#
#.....#...#.......................#....#
#.....#...#.............#..............#
#.....#...#........................G...#
#.....##..#....#......................##
#.....#...#............................#
#.##..#...#............................#
#.....#...#..........#.................#
#.....#...#............................#
#.....#...#............................#
#.....#...#............................#
#.....#...#............................#
#.....#...#............................#
#.....#...#............#...............#
#.....####.##............#.........#...#
#.....##.......#.......................#
#.....##....#..........................#
#.....##..#.#........................#.#
#.....##....#....#.....................#
#....##.#####.#..............#.........#
#.....#................................#
#.....#................................#
##......#.....#............#...........#
#..........#.....#...................#.#
#..............#.......................#
########################################
