########################################
#............................#.....#...#
#..............................#.......#
#................#.....................#
##.................#...................#
#............#......................#..#
#...................#.........#..#.....#
#............G........#................#
#.....#.................#..............#
#.............................#........#
#.......#..............................#
##...............#.......#.............#
##...........##........................#
#......................................#
#......................................#
#.....#.........#......#...............#
#....................................#.#
#........#..................######.#...#
#.........................#.#...#......#
#.............................#.##.....#
##.#..#....#................#...#......#
#.####.#....................#...#.....##
#.#....#.............#......#...#......#
#.#....#...........#...#...............#
#......#...............................#
#.#....#...............................#
#.##.#######################...........#
#.............#........................#
#......................................#
#...................................#..#
#...S...#.............#................#
#.....#..#####................#........#
#........#...#......###.#..............#
#...#....##..#......#...#.....#........#
#........#...#......#...#..............#
#...#.#..#...#..........#..............#
##.#.....###.##.....#####..............#
#.....#................................#
#......................................#
########################################
