########################################
#......................................#
#........#..#............#.............#
#......................................#
#......................................#
##.....................................#
#.............................#........#
#...................#..................#
#..#................#..................#
#......#...#........#..................#
#............#.....####................#
#...................#...............#..#
#.........#.........#.............#....#
#.........#.....#...#..................#
#.........#.........#.......#..........#
#........##.........#.......#.........##
#.........#.........#..................#
#...#.....#.........#...........#......#
#.........#......#..##.................#
#.........#.........#..................#
#.........#.........#..........#......##
#.........#.........#..#.......#.......#
#.........#......#..#..................#
#.........#.........#..................#
#.#.......#.........#........#........##
#.....#...#....#...S#..................#
#.........#.........##......#..........#
#.........#.........#..................#
#.........#.......#####................#
#.........#.......#.##...#....#........#
#.........#.....#.#.##.................#
#.........#..#.#..#.###..............#.#
#G.....#..#.......#.##.................#
#..#.############################......#
#.........#.............#..............#
#.........#.........#..................#
#......................................#
#..#....##..........#.#.#..............#
#....#.................................#
########################################
