########################################
#......................................#
#..#...........##......................#
#..............#...#..........#......#.#
#.....................................##
#..................#...................#
#............#.........................#
##................G........#....#......#
#..............#.............#.........#
#....#.................................#
##...#####.########################....#
#.............................#........#
#...................######.............#
#...................#....#.#.......#..##
#.............#.....#.........#........#
#...................#........#......#..#
#...........#.......######.............#
#......................................#
#......................................#
#..................................#...#
#......................................#
#......#................#.#............#
#........#..............#..............#
#...................S..................#
#...........................#..........#
#..#....#.#............#...............#
#..#....#..................#.........#.#
#..#....#.......#......................#
#..#....#.................#.####...#...#
#..#....#...................#....#.....#
#..##.###.......#...........#....#.....#
#..#.........##.#...........####.......#
#......#...............................#
#..#....................#..#.........#.#
#........................#........#....#
#.............#........#...............#
#.#.............................#......#
#..#...................................#
#..............................#.......#
########################################
