########################################
#.........................#............#
#.........#............................#
#....#...................#...#.........#
#........................#.............#
#................#...#.#.#.............#
#..................#...#.#.......#.#...#
#........#.........#...#.#..#....#.....#
#........#.#.......#...#.#.............#
#....#............##...#.#.............#
#..........#.......#####.#.............#
#..........#.............#.......#.....#
#..........#.............#.............#
#..........#.............#.......#.....#
#..........#..#..#.......#.............#
#.....#....#.............#........#....#
#..........#.............#......#......#
#..........##............#............##
#..........#.....#.......#.............#
#....#.....#............##............##
#........G.#.............#.............#
#..........#.............#....#........#
#..........##............#.......#.....#
#..........#.............##............#
#..........#.............#.#...........#
#..........#..#..#####...#.............#
#..........#....#....#...#.............#
#..#.......#.........#.................#
#..........#.S...#...#...#.............#
#........#.#.....#####...#.............#
#..........#.......#.....#..#..........#
#.........###............#.............#
#..........#....#........#........#....#
#..........#.............#.............#
#.#...#....#.............#.............#
#..........#.............#.............#
#..........#.............#.............#
#..........#...........................#
#.........#...#..#......#..............#
########################################
