########################################
########..####.#########################
########.#####.#########################
########...###.##.######################
########....................##.#########
########.#.################.##.#########
########.#.################.##.#########
########.##################.##.#########
#######..#########.#######..##.#########
########.#########..#######..#.#########
########.#########.########.##.#########
########..########.########.##.#########
########.#########.########.##.#########
########.#########.########.##.#########
########.###..####.#######.....#########
########.......................#########
############S############...##.#########
###########################....#########
###########################.##.#########
###########################.#...########
###########################.##.......###
###########################.##.#########
###########################..#.#########
###########################.##.#########
#####################.......##.#########
#################.#########..#.#########
#################.#.#######.#..#########
################G..............#########
####################..###......#########
####################.######.##.#########
####################.######.##.#########
####################.######.##.#########
####################..#####.##.#########
####################.######.##.#########
###########################.##.#########
#######################...........######
##############################.#########
########################################
########################################
########################################
