########################################
########################################
############.###########################
############.###########################
############.###########################
############.###########################
############..##########################
############.......#####################
############.####.######################
############.###########################
############.###########################
############.....#######################
############....########################
##############.#########################
##############.#########################
##############.#########################
#############..##################.######
##############.##################.######
##############.##################.######
##############.###.##############.######
##############.......#######.####.######
#########.........................######
##############.#####......###.##..######
##############.######.#######.###.######
##############.######.######......######
##############S....##..#########..######
#############...#####.###########.######
##############.######.###########.######
##############.######.###.######..######
##############.#####..##..#######.######
##############.#####..###.#######.######
##############.######..##.#######.######
##############.######.###.#######.######
##############.#####..............######
##############.########.##.#G####.######
##############..#######.#########.######
##############.########.################
##############.########..###############
########################################
########################################
