########################################
########################################
########################################
########################################
#################################.######
##########.###############.........#####
#.......S..#################.#####.#####
#.########.#################.####...####
#.################################.#####
#.################################.#####
#.##.......................####.##.#####
#.##.#########.###########.###.....#####
#.##.#########.###########.####.##.#####
#.##.#####################.####....#####
#.##.#####################.#######.#####
#.##..####################.#######.#####
#.##.#####################.#######.#####
#.##.#.###################..######.#####
#.##.#.###################.#######.#####
#..#.#.#################...#######.#####
#....#G###################.#######.#####
#........#################.#######.#####
#.##.#.#..###.############.######....###
#.#................................#####
#.######..####.#####.#####.#############
#.######.#####.###########.#############
#.#####..#####.###########.#############
#.######.#####.###########.#############
#........#####.##########..#############
#.#####..#################.#############
#.#####....#############.#.#############
#.######...................#############
#.#######.##############.###############
#.######################################
########################################
########################################
########################################
########################################
########################################
########################################
