########################################
########################################
########################################
########################################
########################################
########################################
########################################
########################################
########################################
########################################
########################################
#######################.################
#######################.################
#######################.################
#######################.################
#####################.#G.#.#############
#################....................###
#################..######.#.##.#.###.###
#################........#####...###.###
#############.###.#######.#.##........##
############......#######...##.#.##.####
#################.#######.#.##...#######
#################.####.##.#..#.#########
#################.##S..........#########
#################.###..##..###.#########
################..###.###.####.#########
#################...............########
#################.####.#######.#########
#################..###.######..#########
##############################.#########
##############################.#########
##############################.#########
##############################.#########
##############################.#########
##############################.#########
##############################.#########
##############################...#######
##############################.#########
##############################.#########
########################################
