####################
#S##################
#.##################
#..#################
#.##################
#.##################
#.##################
#.##########.#######
#.##########.#######
#.##########.###.###
#.#########.......##
#.#########..###..##
#.######.##..###..##
#.######.##..####.##
#..##.##.##.####..##
#...........#####..#
##.########.#####..#
###########.####..##
###########.#####.G#
####################
