########################################
####################.####.##############
##################.#..###.##############
##################...............#######
############.S.....###.#########.#######
##################.#############.#######
##################..############.#######
##################.#############.#######
##################.#############.#######
##################.#############.#######
###########.######.#############.#######
##########............##########.#######
##########...####..#############.#######
#########....###################.#######
######...............G......####...#####
#######..######.#########.#.####.#######
#########################.#.####.#######
###########################.####.#######
#####################.#..##.####.#######
##############.......................###
##############..###########.####..######
###########################.############
###########################.############
###########################.############
###########################...##########
###########################.############
###########################.############
###########################.############
#################.#########.#.##########
#########.....................##########
###########..##############.############
############.##############.############
###########################.############
###########################.############
########################################
########################################
########################################
########################################
########################################
########################################
