########################################
######################################.#
######################################.#
#############################.########.#
########.####################.########.#
#######................................#
########.#######.####..#.#############.#
########.#.......#####.#.############..#
########.#.#..########.#.#############.#
#####....................#############.#
######.###.....####.......############.#
##########.##..#######.#.#############.#
##########.##..........................#
##########.####.#####.##.###############
##########.####..#######.###############
##########.####.########.###############
##########.####.########.###############
##########.###..########.###############
##########.####.#######..###############
##########.#############.###############
##########.#############.###############
##########.#############.###############
##########..############.###############
##########.#############.###############
##########.############...##############
##########.#############.###############
##########.#############.###############
##########.#############.###############
##########.#############.###############
##########.#############.###############
##########.#############.###############
##########G#############.###############
#########..#############.###############
####.......############...##############
#########..#############.###############
##########.#############S###############
##########.#############.###############
#########....########....###############
##########...............###############
########################################
