########################################
########################################
########################################
########################################
###.####################################
###.#.#########.########################
###................#####################
###..########..###.#####################
###.###.............####################
###.###.#####.#####.####################
###.###.####........####################
###.###.###########.####################
###.###.###########.####################
###.###.###########..###################
###..##...#########.####################
#...##..#..########.####################
###.###.#.#########.####################
###.###.#..########..###################
###.................S....###############
###.###.#####.#####..#.#.###############
###.###.#####.#####.####.###############
##..###.#####.#####.####.###############
###.###.#####.#####.###..###############
###.###.#####.#####.####.###############
###.###.#####.#####..###.###############
###......##########......##.############
###.###.################.##.############
###.###.################.#..############
###.###..###############.#..######.#####
###.###............G...............#####
###.####.####..#########.##.############
###.#########...########################
###.#########..#########################
###.##########.#########################
###.####################################
########################################
########################################
########################################
########################################
########################################
