########################################
########################################
############################.###########
############################.###########
############################.###########
############################.###########
############################.###########
##.#.#######################..##########
##....#########....G.............#######
#.....#######...####.##.##..#.#.########
##.##.#########.#######......###########
##S##.#########.#######.################
##..#.#########.#######..###############
##.##.####.####.#######.################
##..............#######.################
##.##.########.########.################
####...#######.########.################
#####.#############..##.################
#####.############......################
#####.##############.##.################
#####.#################.################
#####..################.################
#......################.################
###....################.################
####...################.......##########
#####.................#.################
################.######.################
################.######.################
################..#####.################
################.######.################
###############..######.################
################.######.################
#######################...##############
########################################
########################################
########################################
########################################
########################################
########################################
########################################
