########################################
########################################
########################################
##############.#########################
##############.#########################
##############.#########################
###########.##.#########################
###########.##.############...##########
###########.##.#.##########.#.##########
########...............####.#.##########
########.#.####..##.#######.#.##########
########.#.#####..########....##########
########.#............#####.#..#########
########........##.########...##########
#######.....######.########.#.##########
########...#######.########.#.##########
########.#.#######.########.#.##########
####.......#######.########.#.##########
########.#.#######.########.#.##########
########.#.#######.########.#.##########
########.#########.#######..#.##########
########.#########.########.#.##########
########.#########.########...##########
#######...########.########.#.##########
########.#########.S#######.#.##########
########.#########.########.#.##########
########.#########.#######....##########
########.#########.########.#.##########
########.#########.########.#.##########
########.#########.########.############
########.#########.########.############
########.#########.#####....############
########.#######.#.########..###########
#######............####G###.############
########.##############.###.############
#####....##############.###.############
######.#.#####.########.###.############
########....................############
########################################
########################################
