########################################
########################################
###################.####################
#########...............################
#############..########.################
#############..########.################
#############..########..###############
#############.#########.################
#############.#########.################
#############.#########.################
#############.#########.########.#######
#############.#########.########.#######
#############.#########.########.#######
#############.#######.G.#######..#######
#############.#########.#######...######
#############.#########.#######..#######
########......########..#######..#######
#############.####......#######..#######
#############....#####.########..#######
#############...###############..#######
#############.#################...######
#############.#################..#######
#############.#################..#######
#############.#################..#######
#############.#################...######
#############.#################..#######
#############.################...#######
#############.#################..#######
#############.#################..#######
#############.#################..#######
#############.####.#######.......#######
#######.#####.####.########.#.#...######
#######.#####.####.##########.#..#######
#######.##.##.#.##.####.#####.#..#######
##...............................#######
#########.##..#.#######.#####.#..#######
#########.###.###########.###.#..#######
#########.###.######..........S..#######
#########.############.##.####.#########
########################################
