####################
#S##################
#..#################
#.####.#############
#.####.#############
#.####.#############
#.####.#.###########
#.####....##########
#..#....#..#########
#.......#.##########
####...##.##########
#########.##########
#########.##########
#########.##########
#########...#.######
#########..........#
##########..####..##
##########.######.##
#################.G#
####################
