########################################
########################################
########################################
########################################
########################################
########################################
########################################
########..##############################
########..#.############################
########....############################
########..#.############################
########..#.############################
#######.....############################
########....############################
########..#.............G.............##
########..###########..##.###########.##
########..###############.###########.##
########..###############.###########.##
#######...#################.#########.##
########...################.#########.##
########..#################.#########.##
########..#################.#########.##
########..#################.#########.##
########..#################..########.##
########....S....................####.##
########..#####..###########...######.##
#######...##################.#.######.##
########.###################...######.##
########.###################.#.#####..##
########.#####################..#####..#
########.#####################.######.##
########.############################.##
########.############################.##
########.###########################..##
########.#######################......##
########.#.#########################..##
########..............................##
###############################.########
###############################.########
########################################
