########################################
############.##########.################
############.#########..################
############..#######...################
#########...............################
#########..###########..################
#########.............................##
########...####.######..#.#######.###.##
#########.#####.######.##.#..#.##.###..#
#########...........................S.##
######################.#..#.###.########
######################.##.##############
######################.##.##############
######################.##.##############
#####################...#.##############
######################......############
######################.##.##############
######################.#..######.#######
######################.##.######.#######
######################.##.######.#######
######################.......###.#######
######.########.###.##.##.######..######
#####........................G.......###
######.###.####.##################.#####
######..##########################.#####
######...###############################
######.#################################
######.#################################
#####..#################################
######.#################################
######.#################################
########################################
########################################
########################################
########################################
########################################
########################################
########################################
########################################
########################################
