########################################
########################################
########################################
########################################
########################################
########################################
########################################
########################################
############.###########.###############
############................############
############..##.......#################
############..##.###.#.##.##############
############.###..##.#.##.##############
############.##..#.....##.##############
############..##..##.#....##.#..########
#########.....................#.########
############.##..S##.#.#.###.##.########
############..##..................######
###########..#######.#.#.###############
######################....##############
#####################..#.###############
######################.#.###############
######################.#.###############
######################...###############
######################.#.###############
###################.##.#.###############
##################..G....###############
######################...###############
######################...###############
######################.#.###############
######################.#.###############
######################.#.###############
######################...###############
######################.#.###############
######################.#.###############
######################...###############
########################################
########################################
########################################
########################################
