########################################
#############.##########################
#############.##.######.########.#######
#####.................................##
################.#####.####.####..###.##
################.##########..###..##..##
################.##########..###..###..#
################.#######.....###..###..#
########################.###.###..###..#
########################.###.####.###..#
##########..............S..............#
###########.#######.####.###.########..#
########################.###.########..#
########################.###.########..#
########################.##..#######...#
########################...............#
###########################..#.####.#..#
############################..#######..#
############################.########..#
############################.####G###..#
############################.##........#
############################.########..#
############################.####......#
############################.########..#
######################################.#
######################################.#
######################################.#
######################################.#
######################################.#
#####################################..#
######################################.#
######################################.#
#####################################..#
######################################.#
######################################.#
######################################.#
######################################.#
########################################
########################################
########################################
