####################
#S##########.#######
#..####.####.#######
#.###.#.####.#.#####
#.##..............##
#.##..#####.###.####
#..#.##########.####
#.#..#########...###
#.##..#########.####
#....##########.####
#.##.##########.####
#....##########.####
#.##.##########.##.#
#.##.##########..#.#
#.##.##########.#..#
#..#.##########....#
#....############..#
#################..#
##################G#
####################
