####################
#S.#################
#.##################
#..######.........##
#.#######.#.###.####
#.#######.#####.####
#.#######..####.####
#.#######.#####..###
#.#######.#.....####
#.#######.......####
#.#######.#####..###
#..#####..#####.####
#..#.####.#####.####
#.........#####.####
#.##.#.#.######..###
#.############..####
#.#############.####
############....####
###############...G#
####################
