########################################
##############...........###.###########
###############.#.#..#..####.###########
###############.####.##.####.#######.###
###############.................####.###
################.#.####.##.###.#####.###
################.#.####.######.#####.###
################.#..###.######.#####.###
################.#.####.######.#####.###
################.#.####.######.#####.###
#######################.######.#####.###
#######################.######.#####.###
#######################.######.#####.###
#######################.#......#####.###
#######################.######...###.###
#######################.######.#####.###
#######################.#####..#####.###
#######################.######.#####.###
#################.....S.######.#####.###
#######################.######.#####.###
#######################.######.#####G###
#######################..#####.....#.###
#######################.######.#..##..##
#######################.######.#####.###
#######################.######.......###
#.......................##########....##
###########...........................##
###########.#.###########.##########..##
##########...#######################.###
###########.########################.###
########################################
########################################
########################################
########################################
########################################
########################################
########################################
########################################
########################################
########################################
