########################################
##########.#####.#######################
##########.#####.##..###################
##########................S.....########
##########.#####.#######################
#########..#############################
#########..#############################
##########.#############################
##########.#############################
##########.#############################
##########.#############################
##########.#############################
##########.#############################
##########..##.#########################
##########.###.#########################
##########.###.#####.###################
##########..#..........#################
##########.##.#######.##################
##########.##..######.##################
##########.##......##.##################
##########.##.#######.######.###########
##########.##..#####...#####.###########
##########.##...##...........###########
##########.##.######......##.###########
##########.##.####....######.###########
##########.##......#..######.###########
##########.##.###.##..######.###########
##########....#####...######.###########
##########.##.######..######.###########
##########.##..#####..####.#.###########
##########.##.####...........G.#########
##########.##.######..##################
##########.##.#####...##################
##########....####....##################
####################..##################
#####################.##################
########################################
########################################
########################################
########################################
