########################################
#######################..##########...##
#####################.##.###########.###
#####################.##....####.###.###
#####################.##.#######.###.###
#####################.#..######...##.###
####################..............G...##
####################.###.###############
####################.###.###############
##################.......###############
####################.###.###############
####################.###.###############
####################.###.###############
####################.###.###############
####################.##...##############
####################.##...##############
####################.#...###############
###############.####.##..######S########
#................................#######
#.#####..#.#######.#.#.#...####.########
#.######.#.###.#####.#.#.###############
#.######.............#.#.###############
#.######.###.#########.#.###############
#.####################.#.###############
#.######################.###############
#.######################.###############
#.######################.###############
#.######################.###############
#.######################.###############
#.######################.###############
#.######################.###############
#.######################.###############
#.#####################..###############
#.#####################..###############
#.#####################..###############
#.#################.####.###############
#.#################.####.###############
#........................###############
##########.#############.###############
########################################
