########################################
###########.############################
###########.#..#########################
###########....#########################
###########....##########.#####.########
########...........................#####
############..#########.#.#.######.#####
#############.####################.#####
#############.####################.#####
#############.##################.#.#####
#############.#################..#.#####
#############.##################.#.#####
#############.##################.#.#####
#############G#############.####.#.#####
#############.#############.####S...####
#############.############...###.#.#####
############...#####...............#####
#############.#####..############.######
####.########.######.###################
####.########.######.###################
###..#####....#####...#######.##########
####.########.#####..########.##########
###..#####.##.###.#...#######.##########
####.................########.##########
###########.#.#####..########.####...###
###########...#####..########.####.#####
###########.#......................#####
###########.#.###############.##########
#############..#########################
#############.##########################
########################################
########################################
########################################
########################################
########################################
########################################
########################################
########################################
########################################
########################################
