########################################
########################################
########################################
########################################
########################################
########################################
########################################
########################################
########################################
########################################
########################################
#####################.###.##############
#########.######............############
########..######.####.##################
#####.###.######..###.##################
#####.###..#####.####.##################
#####.###.#####...###..########.########
#####.###.######.####.#########..#######
#####..............##.#########.########
##############...#.....########.########
#####.................#########.########
#########....###.#.#.#########...#######
###########....#..S..............#######
###########.#.#..#.###.###.#############
########....####.#.###.#################
###########G####.#.###.#################
###########.####.#.###.#################
###########........###.#################
########################################
########################################
########################################
########################################
########################################
########################################
########################################
########################################
########################################
########################################
########################################
########################################
