########################################
########################################
################################.#######
###############################..#######
################################.#######
##############################.#.#######
##############################...#######
###########.###############.......######
###########.###############.###.#.######
########.##.###############.###.#.######
########.##.###############.###.#.######
########.#...####.###.#####.###.#.######
########....................#####.######
#######..################..######.######
########.#########...#####.######.######
########.######.###.##.###.######.######
#######..######.###..#.###.######.######
########.#####..###.##G###.#####..######
########.######.###.##.###.######.######
########.##.###.#.#.##.####.#####.######
########.#...................####.######
########.##################..####.######
########.###################.####.######
########.###################.......#####
########.#####################.#########
######.#.###############################
######...###############################
####......##############################
######.#.S.#############################
######.#.###############################
####...#........########################
#........#####.#########################
#####.##.###############################
########.###############################
########################################
########################################
########################################
########################################
########################################
########################################
