########################################
########################################
########################################
#####################.##################
##.########.#########.##################
##.########.#########.##################
##.########.#########..#################
##..........#########.##################
##..#################.#####.############
#...........................############
##.#.###############.##.##..############
##.#.###############.####......#########
##.#.#####################..############
##.#.#####################.#############
##.#.####################..#############
##.#.#####################.#############
##.#.###################...#############
##.#.#####################.#############
##.#.#####################.#############
##.#.#####################.#############
##.#.#####################.#############
##.#.#####################.#############
##.#.####.################.#############
##.#.####..#########.......#############
##.#.####.################.#############
##.#.####.################.#############
##................########.#############
##.#.###.#.#####.#########.#############
##....####.#####.#########.#############
##.#.#####.###.#.#########.#############
##.#.#####S###...#########.#############
####.#####..####.#########.#############
####.#####.#####.#########..############
####.###########.#######################
####.###########.#######################
####..##########.#######################
###...##########.#######################
####..###.##...G..######################
####.................###################
########################################
