####################
#S##################
#.##################
#.##################
#.##################
#..#################
#.##################
#.##################
#..#########.#######
#..########...#.#.##
#.##########.......#
#.##########.##.##.#
#.##########..#.##.#
#.######.#.#..#.##.#
#.............###..#
#.####.#.#.#######.#
#.####.###########.#
#.####.###########.#
######.###########G#
####################
