########################################
#####################.##.###############
#####################.##.########.######
#####################.##.########.######
#####################.##.########.######
#####################.##..##.####.######
###########..........................###
#########################.##..###.##.###
############################..###.##.###
#############################.###.##.###
#############################.###.##.###
#############################.###.##.###
#############################.#.#.##.###
#############################.#.#.##.###
##################.##########.#.#.##.###
#################..##########.#.#..#.###
##################.##########.#.#....###
#########..............................#
#########.###..####...................##
#########.###.#####.#############.#..###
#########.###..####.#############.#..###
#########.###.#####.#############.#..###
#########.###.#####..############.#..###
#########.########.G#############.#..###
#########.#########.#############....###
########.S#########.#############.#..###
#########...######..#############.#..###
#########.#########.#############....###
#########.#########.###############..###
#########.#########.###############...##
###################.###############..###
###################.###############..###
###################.###############..###
###################.###############.####
###################.##############..####
###################.###############.####
###################.###############.####
###################..##############.####
###################.................####
########################################
