########################################
###################.####################
#########.#######.#.#####..##.##########
#########...................#.##########
#########...####.###..####.##.##########
#########.#..#######.#####..#.##########
#########.#..#######.#####.##.##########
#########.#..#######.#####.##.###.######
#########..........................#####
#########....#######.####..######.######
#########.###############......#...#####
########..##########..............######
#########..###########.##..#############
#########..###############.#############
#########..###############.#############
########..........G....###..############
########..##########.#####..############
########..###############.....##########
########..################..############
########..################.#############
########..################.#############
########.....S.............#############
########.###############################
########.###############################
########.###############################
########.###############################
########################################
########################################
########################################
########################################
########################################
########################################
########################################
########################################
########################################
########################################
########################################
########################################
########################################
########################################
