########################################
###############################.########
###############################.########
###########################.###.########
###########################.....########
###########################.###.########
##############################...#######
###############################.########
###############################.########
###############################..#######
###############################.########
###############################.########
###############################..#######
###############################.########
#############.#################.########
#############.##########.##.###.##.#####
############.............G.............#
##################.########.###..##.####
##################.###########...##.####
##############################...##.####
#####################.#########..##.####
#####################.#########..##.####
#####################.#########.###.####
###################.#...#######.###.####
#################...............###.####
###################.###..##########.####
###################.####.##########.####
###################.####.#########...###
###################.####.##########.####
###################.####.##########.####
###################.##.#.#########...###
###################.##.############.####
##################........#########.####
###################.##.############.####
###################..#.######..####.####
###################.##.######..####.####
##################........S.........####
###################.#########.#####.####
###################.###############.####
########################################
