########################################
########################################
########################################
########################################
################.#######################
################.#######################
#....###########....####################
###G.###########.##.####################
###..###########.##.####################
###..##########...#.####################
###.......######.##.####################
###..##.#.#####..##.####################
###..###########..#.####################
###..###########.##.####################
#....###########.##.####################
###..##########...#S####################
#....###########.##.####################
###...##########.##.####################
###..###########.##.####################
###..###########.##.####################
###..###########.##........#############
###.############.##.####.###############
###.#########....##.####.###############
###.....########.#######.###############
##...............#######.###############
##........######.#######.###############
##..####################.###############
##..####################.###############
##..####################.###############
#...####################.###############
##..####################.###############
##..####################.###############
##..############.#######.###############
##..############.######..###############
##.......................###############
##..##############.####...##############
##.......###############.###############
########################.###############
########################.###############
########################################
