########################################
###.##.#################################
##........S.############################
##.########.############################
##.########.############################
##.########.......######################
##.########..###########################
##.########.############################
##.########.############################
##.########.############################
#..######.#.############################
#..#####....############################
#...#######.############################
#.....#####..###########################
#..########.############################
#..########.############################
#...####################################
#..#####################################
#..#####################################
#...####################################
#..##########..#########################
#...#########..#########################
#.......G...................############
##.####.##########.###.#.##.############
##.##.####.#######.######.#.############
##........................#.############
#####.###..##############...############
#########################.#.############
###########################..###########
##########################...###########
##########################..############
###########################.############
########################################
########################################
########################################
########################################
########################################
########################################
########################################
########################################
