########################################
########################################
########################################
########################################
########################################
########################################
########################################
####################.###################
###################.....################
###################S.##.################
###################.###.################
#############.#####.###.################
######.######.#.###.###.##.#############
#...........................############
#####.######.#..#...........############
#######......#.##...###.##.#############
##########.#.#.###..###.##.#############
########.###.#.###..###.##..############
########.###.#.#....##...#.#############
########..##.#.####.###....#############
########.###.######.##..################
###.####.##..######.####################
##..G....###.######.####################
########.###.######.####################
########.###.######.####################
########.##########.####################
########.##########.####################
########.##########.####################
########.##########.####################
#####..#.##########.####################
####.....#########.....#################
######.#.#########...###################
########.##########.####################
########.##########..###################
######....#########.####################
#####...............####################
########.###############################
########.###############################
########.###############################
########################################
