########################################
########################################
########################################
########################################
########################################
########################################
########################################
########################################
##########.##.########.#################
##########..............################
##########.##.########..################
##########.##.#########..###############
##########.#...########...##############
##########.#..#########.......##########
##########.##.#########.#.##############
########....................############
########.#.###.#G########..#############
########.#.#####.########.##############
########.#.#####.########...############
########....####.####..##.##############
########.######...##....S.##############
################.########.##############
#########################.##############
#########################.##############
#####################.....##############
#########################.##############
######################.#..##############
#####################.....##############
#########################.########.#.###
###################....................#
#####################.#######.#####.#..#
############################..#####..#.#
#############################.#####.##.#
#############################.########.#
######################################.#
######################################.#
########################################
########################################
########################################
########################################
