########################################
########.###############################
########.###############################
########.###############################
########.###.............###############
########.###.####....###################
########.###.#######.###################
########.###.#######.###################
########S###.#######.###################
########.###.#######.###################
########.###.#######.###################
#######..###.#######.###################
########.###.#######.###################
########.###.#######.###################
########.###.#######.###################
########.###.#######.###################
########.###.#######.###################
########.###.####....###################
########.###.####.##.###################
########.###.####.##.###################
########.###.####.##.###################
########.###.####.##.###################
########.###.####.##.###################
########.##..###..#..###################
########.###.####.##..####.#############
########.###..###.##.###.G......########
########.###...##.##.##......###########
########.###.####.##.###..#..###########
########.###.####.##.#######.###########
########.##..####.##.#######.###########
########.###.####.##.#######.###########
########.###.........#######.###########
########.###.####..#.#######.###########
#######..###.####................#######
########.###.#####.#.##.##.#############
########.###.######...####.#############
########.###.#############.#############
########.###.#############.#############
########.......###########.#############
########################################
