########################################
########################################
########################################
########################################
########################################
########################################
########################################
########################################
########################################
########################################
########################################
###############.########################
###############.####.###################
###############..###.###################
###############.......##################
##############..########################
###############.########################
###G###########.########################
###.##########..########################
###...#########.########################
###.###########.########################
###.###########S########################
###.#####.#####.########################
###.#####.......########################
###..####.#####.########################
###.#####.#####.#########.##############
###.#####..###..#####.###.##############
#.#............................#########
#.....#.###.##....######################
#.#...#########..#######################
###...#.#........##.####################
###.................####################
#####.########......####################
#####.#########.###.####################
###############.###.####################
##############........##################
###############.########################
###############.########################
###############.########################
########################################
