########################################
#.........#............................#
#.......#.........#..#......#..........#
#......#...#..........##....#..........#
#.............#......#.............#...#
#........#....#.................#.#...##
#......#...........................#...#
#..#....................#....#.........#
#.....S..................#.............#
#.........#.......#.....#..............#
#........#.....................#.......#
#.........................#....##......#
#........###.........##................#
#............#...........#...#...#.....#
#.........................#.........#..#
#.#......#............................##
#.......#....##.........#...#.#..#.....#
#........#..........#..................#
#.................##........#...#......#
#...................#.#...#...........##
#....#....#....##...............#..#...#
#...............................#..#...#
#..#.....#..#........#.............#...#
#...................#..........#.....#.#
#.........#...................#....#..##
#....#............#....#......#.....##.#
#.......#.............#..#.............#
#...#................#.#...............#
#...................#..#..............##
#...........#......................#...#
#.......#...#..#.......................#
#...#.....##.#......#...#..........#...#
#......................................#
##.#.......#....#.....#.............#..#
#.......................#.##...........#
#.....###................#...G.........#
#...........#.....#.##.................#
#...............#....#....#.#..........#
#...##.#...............#.......#...#...#
########################################
