########################################
#......##....................#..#....#.#
#..........#........#..........#.......#
#....#.##.#..#.....#.................###
#...............#......................#
#........#.............................#
#...............................#......#
#............#................#........#
#...............#...#..............#...#
#.................#....#..#............#
#....#................###....#........##
#....#...............#.................#
#............##.........#........#.....#
#..............#.......................#
#......................................#
#...##............#..#.................#
#..........................#..#.......##
#.........G........#.......#...........#
#.............#.#.....#...............##
##..##.........#......#.......#........#
#....................................#.#
###..................#.........#.#.....#
#....................#...#.........#S..#
##.#...........................#......##
##................#................##..#
##............#......###...............#
#...#......#...........#..#......##.#..#
#..........#....................#....#.#
#.........#........................#...#
#......#.....#.#...........#...........#
#...........#..........#.#....#......###
#....#....#...........##...............#
#...#.........#........................#
#......................................#
#.#.....................#..............#
#..#......#........#...###....#.##.....#
#...#.#........#.......................#
#.#...#.#....#...#.........#..#...#....#
#...............................#..#...#
########################################
