####################
#S.................#
#...#..............#
#...........#......#
##.................#
#.#................#
#....#...#.......#.#
#......#...........#
#.............#....#
#....#...........#.#
#..........#.......#
##..#...#..........#
#.........#........#
#......#.....#.....#
#..................#
#................#.#
#.......#..........#
#..................#
#..........#......G#
####################
