########################################
#.................................#....#
#..#............#......................#
#..............#................#......#
#...#...........#...#....#.............#
#................#.....#.......#..#....#
#...#...#.......#......#...............#
#.............#.............S..#..##..##
#........#........................#....#
#........#.............#...............#
#...............#.......#..............#
#....#......#....#......#.#............#
#.#....#....#.........................##
#..#...........#........#....#.....##..#
#....#...............#.................#
#......................#.......#....#..#
#......#...............................#
#..#..........#....#......#............#
#.#..................................#.#
#.....#....#................#.........##
#...............#....#...........#.....#
#...#..................#.........#...#.#
#.......#.....#........................#
#..##.#.#.#............................#
##.......#....#...#...#................#
#........#...............G.............#
#.......................#..............#
###..............#.......#.............#
#............#...........#....#........#
#.##.....#.....#.......#...............#
#...............#..........#.....#..#..#
#...........#....#................#....#
#...#...................#..........#...#
#.#...........#..............#.........#
##.##..........#..#..............#.....#
#......#.......................#..##...#
#.#..#.......#.....#............#..#...#
#......#...................#..#...#....#
#...#......#....................#......#
########################################
