########################################
#....#......#......##..................#
#........#....................#........#
#..#.#.................#.#.............#
#..#...................................#
#.....#...#...........#................#
#...............#.#....................#
##..................#..........#..#....#
#.#................................#...#
#...#.........#..................#.....#
#...................#............#.#...#
#..........#...............##..........#
#................#.............#.......#
#......#...................#.........#.#
#.....#.......#....#.............#.....#
#..............#............#......#...#
#..................#.#.................#
#...##...........#........#.......##...#
#...........#.............#............#
#...#.................................##
#.....#.......#.......##.........#.....#
#.#.......##...........................#
#...#.#..............#.................#
#.......#....#.........................#
#....#....#.....#................##....#
#...............#.##......S............#
#...................#..................#
#.......#..................#...........#
#......#.....................#.........#
#......................................#
#.......#....##...............#.....#..#
#....#......#....#.........#....#...#..#
##.#.....#....#....#.....#.....#.....#.#
#....................#......#.#...#....#
#......#....#.........#................#
#.......#.......#.#....#.#.#..#.G.#....#
#.#....##..#...#....#........#...#..#..#
#...#.##..#.......#.........#...#......#
#...#..........#....##........#........#
########################################
