########################################
#.#..............#.................#...#
#.........#..........#......#...#..#.#.#
#..........................#.....#.S..##
#.....#.....................#.........##
#......#......#.....#.....#.........#..#
#..#.....................#....#........#
#.......#..............................#
#....#..........#.#....#...............#
#..#.........#.#....#.....#............#
#..#..........................#........#
#......................#...#........#..#
#..........#.#.......#................##
#...........#..........................#
##.#........................#....#...#.#
#......#......#.#.#.##........##.......#
#...#....................#...#....#.##.#
#...................#................#.#
#........#....#....................#...#
#.................#.......#........#...#
#.#...#.............#...#..............#
#......................##..#...........#
#.#..#.#...............................#
#.............#................#..#.####
#................#..#..................#
#....#.......#.........................#
#..#.....#.......#....#......#....##...#
#..#................##..............#.##
#..............#...#......#..#..#......#
#......................................#
#.#.#.#....#.......#....##...........#.#
##................#...#................#
#........#...#..#......................#
#.........#.......................#....#
#......................................#
#.G..............#...........#.........#
#............................#...#....##
#..............#.......................#
#...........#......................#...#
########################################
