########################################
#................#..............#.....##
#...............#...............#......#
#...................#.............#..#.#
#.......#..............................#
#........................#....#........#
#...#................#.................#
#........#...........#..#..............#
#...........#..#.#.........#.....#.....#
#..#.#..#.#.....................##.....#
#..........#..#..#.....#.............#.#
#.............................#........#
#...G..#.................#.............#
#....................##........#.......#
##.#...#.....#................#..##....#
#..#.#....##...........#............#..#
#.....#........#...#......#........#.#.#
#....#.............#...................#
#.................................#....#
#........#....#......#...........#.....#
#...........................#........#.#
#..................#...................#
##.#.........##...............#........#
#................#..........#..........#
#.........#......#......#............###
#.....#........................#.....#.#
#...........#........#........#........#
#....#..................##.##......#...#
#.........#...##....................#..#
##..#...........#......................#
#.#.....#............#......#.......#..#
##......##..............#..............#
#...#..#......#.......#..........##....#
#..#.....#......#.....#................#
#.....#..........#............#.......S#
#..#...#.......#.......................#
#...........#...................#..#...#
#..........#....#.....#...#............#
#.#.........#..#.....#.........#..#....#
########################################
