####################
#S.................#
#............#.....#
#............#.....#
#.......#......##..#
#..#.........#.....#
##.....#..#........#
#..................#
##.................#
#................#.#
#......#.....#.....#
#....#.............#
#..#..#.....#......#
#.#.##.......#.....#
#..................#
#..................#
#.#...#...#.#......#
#........#.........#
#.........#.......G#
####################
