########################################
#.#.......#....#.....#.........#.....#.#
#.................##.....#.............#
#.......#.....#....#..............#....#
#...........................#..........#
#...#.#..#............#.#..........#...#
##.....#..........#....................#
#.................#...#.............#..#
#...................#.....#............#
#.............#......#.................#
#......................#.............#.#
#.#...........#...........#....#.......#
#................#..................#.##
#..S................##.......#.........#
#......#.........#.......#.#...#...#...#
#.....#..#.#...........................#
##...#.......#..#......................#
#......................................#
#......................................#
#.......#......#......................##
#.....#........................##......#
#..#.#..................#..............#
#..........#...........#....#.....#....#
#..##.................##..............##
#.........#.....................#...G..#
#...........#.....#.................#..#
#...#......#..........................##
#......#.........................#..#..#
#................##..#..............#..#
#...........#...............##.........#
#.................#....................#
#..#.........#..#....#....#.......#..#.#
#......#.........#.........#..#........#
#....#.....................#.#........##
#.......#...........#.......#..#.......#
#......#......#......#....#...#........#
#........#.............#......#.......##
#.......#.............##..........#..#.#
#.................#............#.......#
########################################
