########################################
#.....#.....#.......#...............#..#
#....#..#.....#...#.....#........#.....#
#.........#......#.....#...............#
#..................#...#..#..#......#..#
#...............#.....................##
#...................#............#....##
#..#...#.....#..#........#....#...#....#
#...............#.#....................#
#.....#...................#.....#......#
#.....#...#............#...............#
#..#.....#.#.#.....#....#..............#
#............#...............#.........#
#.......................#..............#
#...................#............#.....#
#....#......#....#.............#...##..#
#.......................#........#.....#
#.......#.....#................#.#.....#
#.......#...#.......#.#......#..##.....#
#..........#...........................#
#......................#...............#
#.......G......#.........#....#.#......#
#...................#..................#
##................#.#..................#
#...............#.......#......#.......#
###.......................#............#
#........#.#.......#..#.....#..........#
#............#......#.....#.....#......#
#...#................................#.#
#.......#.......#...#..................#
#.........#........#............#......#
#.#....#........##....#........#.###...#
#....#........#..#.....#...#..#......#.#
#...#.#.#....#........#.....#.....##...#
#.....................#................#
#......................................#
#......................................#
#......##........##......##............#
#.............S.........#..............#
########################################
