########################################
#.......##.....................#..#....#
#....#...........#..#.....#............#
#.....#..#.#.#.....#..............#....#
#....#......#....................#.....#
#..................#.....#.............#
#.#....#...#....#.....#......#..#.....##
#....#.#...........#...............#...#
#.......#.....#......#..#.........#....#
#.......................#.........#..#.#
#..........#..#...................#....#
#...##.............#.......#...........#
##............#......#..............#..#
#.............#........................#
#...#.....#.....#..#......#..#.........#
#..#.....#.#..#.........#...#..........#
#...................#..................#
#.......#.........#..............G.....#
#...........................#..........#
#...#..............#.....#.............#
#.#...........#........................#
#....#........#........#...#....#......#
#.#.....##..##................#....#...#
#...#........#...#.#..............#...##
#.#..#......#.#.......#....#...........#
#.#......................#.#..#........#
#.......................#..............#
#.......#....................#......##.#
#........................#....S........#
#...#..................#...............#
#.#.......##...#.......................#
#....#...#....................#...#....#
#........#..................#.....#....#
#....#................##..........##...#
#.......#....#.........................#
#.#.....#..#.#.........................#
#.......#.............#.....#..........#
#......#..##...................#.......#
#......#.#....#.......###.....#..#...#.#
########################################
