########################################
#.....#..............#...........#.....#
#............#..#.#...#.....#..........#
#........#.........................#...#
#..........#......#..................#.#
#..#...#.........................#....##
#............#.........#...#......#....#
#....#............#..........#......#..#
#.........#..............#....#........#
#.................#..#......#..........#
#...##...........#.................#...#
#.......#.......................#..#...#
##.................#...........#.......#
#......#..##............#...........#..#
#...#......#.#...................#...#.#
###....#..#............................#
#....................#.................#
#..........#.#......#....#...#.........#
#...............#..#..#.....G#......#..#
#.....#...#.............#.....#.#...#..#
#.........###........#..........#......#
#..#.............#..................#..#
#..#.............#...#.....#...........#
#......#...##.#.......##.#.#...........#
#..........S.....#.........#...........#
#...#...............#............#.....#
#..........#...........#.............#.#
#.......#...............#.......##.....#
#.......#..........................#...#
#......................................#
#..........#...............#...........#
#................#.......#.............#
#.......#...#...#............#.........#
#..#................#..............#...#
#...........#.......#..................#
#......................................#
#....................#..........#......#
#......................................#
#....#....#...#......#.....#...........#
########################################
