########################################
#.........G.....#....#.................#
#......................................#
#.....#.........#......................#
#...#.............#.................#..#
#..#..#....#.........#.................#
#...#..............##...#...#..........#
#.........#...............#.......##...#
#.....#..............#....#............#
#........##........#.#..#..............#
##...#...#.............................#
#..#............##..........#..........#
#......#.#.........#...................#
#.........................#.....#......#
#.#.......#....#.................#.#...#
#..................................#...#
#......................................#
#.........................#............#
#................#..##.............#...#
#..#.#.................................#
#...........#.#........................#
#............#.............#...........#
#....................#......#.....#..#.#
#....#........................#........#
#....................................#.#
#..........#..#........................#
#......#....#.......#....##........#...#
#...................................#.##
#..#....#.....#........................#
#...............#.....#.............#..#
#.#....................#...............#
#.........................#............#
#.........#............................#
#..................#...#.#..#.....#....#
#........#..#......#...................#
#............##......#.............#...#
#..S................##.......#.........#
#................##..#.................#
#.#.............#....#.................#
########################################
