########################################
#.###..#....#...........#......#.......#
#............#........#................#
#.#.........#.............#............#
##.........#................#....#.....#
##.....................................#
#..#...................#...............#
#............................#..#......#
#..G.#................#.#..............#
#....#...........#...................#.#
##........#..........#...#...........#.#
#.#..........#..#..........#..#........#
#.........#.....#.##...................#
#....................#.................#
#.##.......#.......#.....#......#......#
#.#.......#...........#.#.#....#.......#
#.#.................##..#....#.........#
#.##..........................##....#..#
#......................#..........##...#
#...............................#....#.#
#......#...............................#
#........#..#.....................#....#
#....#.....#................#.........##
#......#...................#..#.#......#
#............#....#...................##
#........#....#........................#
#..#...................................#
#...#..................................#
#..............#..........#....#.#.....#
#...........#.#........................#
#..#......#.....#........#...........#.#
#................#.........#........#.##
#.#.....##...#.....#.#................##
#...........#...................#.....##
#.....#.....#........#.#..........#...##
#.......#.S.#....#...#....#.......#....#
#........#.......#...................#.#
#................#...............#.....#
#.....#.........#..#...............#..##
########################################
