########################################
#.....#.........#......................#
#...............#..#.....#.......#.....#
#.......#...#.......#.....#.........#..#
#.#......#..........................#..#
#................###..#....#......#....#
#............#................#........#
#......#..........##...................#
##.......#.............................#
#...##.....#........#.................##
#.........#...........#...............##
#.#..#...#................#............#
#..........#....#.......#...#..........#
#...............#...#..................#
#...............#........#.............#
#...............................#......#
#.#........#.#......#...#.....##.......#
#.......#..............#..........#....#
##........G#......................#..#.#
#..........#..........#........#.......#
#..............#.#................#....#
#.........#.#.#...#....#.........#.....#
#...#....#.....#....#....#............##
#..........#...........#..#............#
#.........#..............##.....##.....#
#..#...........................#.....#.#
#.....#..#...............#...........#.#
#..............#.....###.............#.#
#...............................#......#
#...#..................#..#...#....##..#
#......#............S#.#...............#
#........................#.......#.....#
#.#.....#.......#....#.....#..........##
##.....#...........................#...#
##.....................................#
##....#............#.............#.#...#
#.#....#...........#.........#.........#
#...#....#...........#................##
#............#...................#.....#
########################################
