########################################
#..#..........#...#..#....#............#
#.................#..#....#............#
#..........................#..#........#
#.........#...........................##
#...............##...........#..#.....##
#.....#................#....#...##.....#
#.##.......#...........#........#..#..##
#.......#................#.............#
#......#...#.....#...#...#.............#
##...............#.....................#
#....#....#........#.#...#.#.........#.#
#..................#..#.........#...##.#
#........#.............................#
#......#.......#......#................#
#.#.............#.........#............#
#......#...............#....#.#........#
#..........#..................#.#......#
#........##...................#........#
#...............#.....................##
#..#..................##...............#
#.##...#..........#......#......#......#
#.........#............................#
#..#...................................#
#......#..#........................#...#
#................#......#..............#
#.............#...........#..#.#....#..#
##..............##.......#.##....#.....#
#.......#...#.......#.................##
#........#......G...........#..........#
#...#...#........#...#.................#
#............#.................#...#..##
#..............#.......................#
#..........#......#....#...............#
#.................#.............#....#.#
#.##............#...S...#...#..........#
#.........................#.#........#.#
#........#...........#.....#........#..#
#......................................#
########################################
