########################################
#.....#.........#.....#.#......#.......#
#....#..#..................#.........#.#
#.......##...................#.#.#.....#
#.........#............................#
#..#...#................#.....#.#......#
#...........#...#...............#....###
#......#.#....#........................#
#...................#..................#
#.....#.........................#.#....#
#.................#..#.......#.......#.#
#.......#.....................#........#
#..#....#..#.#.#.#...........#.........#
#....#........#.#......#..............##
#....................#..#...#..........#
#.#..........................#.........#
#...........#.#........#......#.S#.....#
##..........#.#........................#
#........#....#...................#....#
#.........#............................#
#.........................#.....#......#
#.........#....#..................#....#
#....#.......#...............#.........#
#.......................#............#.#
#.#......................#.............#
#.#...#.#.##.....#...#.................#
#..........#...........................#
#..............................##......#
#...................................#..#
#...........#......#......#............#
##..#.........#..#...............#.....#
#..............#............#.........##
##..........#...#.......#.#....#.......#
#.........G........#.................###
#......#........#.....#.....#........#.#
#.......#.#............#.....#........##
#....#..........#..#.#.................#
#....#..#..............#......#.....##.#
#.#..#.................................#
########################################
