########################################
#.....#...#..#.#....#..................#
#....S..........#..#...................#
#...........................#..........#
#.......#.....................#........#
#........#.................#........#..#
#....##.......................#.#......#
##......#.....#.......#................#
#....#........#..........#.......#.....#
#.............#...................#....#
#...................#..................#
#.#.......#....................#.......#
#........#........#..........#..#....#.#
#...............#...........#..........#
#.............#.#.........#............#
#.........#.......#..G..#.....#.......##
#.....................#.....#..........#
#...#....#.................#....#....###
##............#..#.....#..#............#
#...............#.........#.#..........#
#..............#..#...................##
#.........#......................#.....#
#....................#.................#
#..#..........#...................#....#
#..................#..#.#.#.......#..###
#....#.....#......#.............#...#..#
#.#............#.......................#
#..#..................#.......#........#
#...#................................#.#
#.#...##....#..........#..........#....#
#.................#...............#....#
#.#.......#...#....#.................#.#
#.......#.....#..........#.....#.......#
#.......#....#..................##...#.#
#..#.......#............#........#.....#
#.....##.#..................#.........##
##.............#......#....#...........#
#............#..............#......#.#.#
#............................#....#....#
########################################
