########################################
#......................................#
#.....#............................#...#
#.....#........#.......................#
#..#..#..#.........................##..#
#..#..#...........#....................#
#.#..#........#........................#
#.....S....#...........................#
#........#.......#...............#.....#
#......................#....#...#......#
###.............#...##...#.#..#........#
#...#................##...............##
#.........#..........#...#..#........#.#
###..#....................#.....#......#
#....##......#..............#..........#
##..#...................#.......##...#.#
#...#....#...#...............#..#......#
#...G..........#.....#...#.#...........#
#..#...................................#
#...#...............................##.#
#.......#......#.......................#
#.........#....................#.......#
##.................................#.#.#
#........#.........................##..#
#...................#.#............##..#
#..#.......#.......#...#............#..#
#.......................##.............#
##.............#.....................###
#...........#.......#..#..........#....#
#.........#.....#....#....#............#
#............................#..#......#
#...##...#........#.#..................#
#.............#.#.......#............###
#...........#.......##.............#...#
#....#.....#...#......#..............###
##.............#.........#.....#.......#
#............................#..#..#...#
#....#...................#.............#
##........#....#...#.............#.....#
########################################
