########################################
#.#.....#.#..#......#......##..........#
#...#..#......................#........#
#.............#....#.....#.............#
#..........#.#....#..#....S............#
#.............#..........#......#......#
#.......#..............................#
#..#.....................#...#.........#
#...#.................#..#......##.....#
#....................#.................#
##...........G.............#......#....#
#..............#...........#........#..#
#.#.......#.......#....................#
#....#........#...........#...........##
#.......#..#...#........##.........#...#
#...........#.....#....................#
#.............#.....#........#.........#
##............................#........#
#.....#....#.#........................##
##..................#...........##...#.#
#......#........#......................#
#...............#......................#
#...................#........#.........#
#...............##.....#.....#........##
#........#.........................#...#
#.................#....................#
#......#.........#....#........#.......#
#...#...#....#............#....#.......#
##......#.....#.........#.....#.....##.#
##....................#.....#.##.......#
#.......................#.......#.....##
#........##..................#.........#
#....#.##.......#.....#................#
#....................#...#...#.#.......#
#..........................##..........#
#........................#.....#.......#
#......................................#
#.....##....#...........##........#....#
#..#........#.#.........#.......#......#
########################################
