########################################
#.................G..................#.#
#....................................#.#
#..#.......##.............#.......##...#
#............##..#....#..#.#.....#.....#
#....................#....#.##.#.....#.#
#..............#.........#.#.........#.#
##.....................................#
#.#....#.............#.................#
#.....##.............#.................#
#..#....#...#...........#..............#
#......................................#
#.............#.....#.......#.....#.#..#
#.#......#.........................#...#
#...#..............................#.#.#
#.........#...#..........#..........#.##
#..#.........#....#..........#.........#
#...........#............#...#....#....#
#......................#.#...#.........#
##.#..#.............#............#....##
#.....#.....##......#..................#
#.#.........#....#...#.................#
#........#..............#..............#
#....#.................................#
#............#...........#............##
#............#.....#......#.#..........#
#...........................#..........#
#................#...........#......#..#
#.....#..#...........#.#...............#
#...#............#..#......##..........#
#........#...#.........................#
#............#...#...............#.....#
##......#..#......................#....#
#......#....................S..........#
#...##.............#....#.............##
#.......#.........................##...#
#....#......###....####........##......#
##....#.........#......................#
#....#....#......#....#................#
########################################
