####################
#S.................#
#...........#......#
#..................#
#..................#
#..............##..#
#..#...........##..#
#......#......#....#
#......#.........#.#
#......#........#..#
#.#.#..............#
#..........#.......#
#....#......#......#
#..##..............#
#..................#
#....#.............#
#............#.....#
#.......#..........#
#...............##G#
####################
