########################################
#.................#....#..#...#.#......#
#.....#.#...................#..........#
#..............#........#..#........#..#
#.#...............#.#............#.....#
#.......#.......................#......#
#..................##............#.....#
#......##.#...#..................#.....#
#..#....#.#.......#....................#
#......#...........#..#................#
#...............#.#..................#.#
#.....#..............#...........##....#
##...#..........#....#......#.#........#
#............#.#...#.............S..#..#
#..........#....#...................#..#
#..........#.........#.........#..#....#
#.......#.#.#................#.........#
#..........#......#..................#.#
#.......................#..#...........#
#.....#......#.#...............#.......#
#.......#.....#..#.....................#
#........#...#......##.................#
#.#............#...........#...........#
#................##.#.#................#
#........#..............#........#.....#
#...........#..........................#
##..............#......#.............#.#
#..........#...........................#
#G............#.........#...#...#......#
#........##........#...................#
#.....................#......#.........#
#........#.#..#.....................#..#
#......#....#..........#.#.......#.....#
#....##.......#............#...........#
#.#...#.#...........................#..#
#..........#...#.......#...............#
#...#.............#............#..#...##
#....................................#.#
#......................#...............#
########################################
