########################################
#..#................#........#.......#.#
#.................................#....#
#....#........#........#..............##
#............##.....#..................#
#...#.......#.......#......#...........#
#............#.#.............##........#
#.......#.............................##
#................#.....#..#............#
##.........#.......................#.#.#
##................#....#............#..#
#.#.....#................#...#.........#
#...#.....................#..........###
#.....................#...#............#
#....#....#........#..#...#............#
#...........#.#...#....#.......#.......#
#.....#....................#...........#
#......#......#........#.......#.......#
##.......#....#.............#..........#
##........#..........#........#.......##
#....#.......#.......#...........#.....#
#.......#.....#......................###
#......G...............................#
##.....#.......#................#......#
#..#........#....#.#.#.......#.........#
#............................#.......#.#
#..#.......................#..........##
#.....#....#...#...........#.....#..#..#
#............................#.......#.#
#..####....#........#..#.........#....##
#..##...#........#.......#.......#.....#
##........#...#.........#...#.....#..#.#
#.....#........#...#...................#
#..................##...............#..#
#....#..............#..................#
##.#.......#...........#...##.#..#..#..#
#.....................#.....S...#......#
#....#..#...............#............#.#
#......#.#.............#.#.#...........#
########################################
