########################################
#.................#..........#.........#
#.........##......#...................##
#.......................#..............#
####..#.......#.........#..............#
#............................#.........#
#............................#..#......#
#...........#....#....#.......#........#
#..G...................................#
#.............#...........#...##...##..#
#.........##...................##.....##
#........#....#.........#.......#......#
#.......#...............#....##........#
#..#.............#....#.............##.#
#..........#..#....#..#.....#..........#
#.#.......#.#....##....#..#........#...#
#...#....#.......................#.....#
#.....#......#...........#.............#
#..........#......#....##......#.......#
#............................#...#.....#
#........#.#............#...........#.##
#...#..#...........#.#...##....#.......#
#..........#........#................###
#.....#......#......#..................#
#....................#......#.....#.#..#
#.....................#................#
#........##.......#....................#
#..........#.#.............#...#..#....#
#.#.......#....#........#......#....#..#
#..............#...................#...#
#......................#.#....#........#
#.........................#.#..........#
#......#.........#...................#.#
#......#...............................#
#....#.#.......#....#....#.............#
#...#.......#..........................#
#....#.#............##.................#
#..............#.S............#........#
#......#....#........#...............#.#
########################################
