####################
#S.................#
#..................#
#....##............#
#......#...........#
#.#...........#....#
#..................#
#..................#
#..................#
#..................#
#............#.....#
#...#..............#
#..........##......#
#.....#........#...#
#.....#............#
#.............#....#
#..................#
#..................#
#.......#.........G#
####################
