####################
#S.................#
#..#...............#
#......#..#........#
#..............#...#
#..................#
##....#.....#......#
#..................#
#.#....#....#......#
#..................#
#....#.............#
#..................#
##.........#.......#
#.........#........#
#..................#
#.#...#............#
##.................#
#...#......##......#
#.................G#
####################
