########################################
#.......#..............#...............#
#......#...............................#
#............G.....#...................#
#........................#......#.#....#
#...........#....#...#.#.............#.#
#..........#......#.#..................#
#.#................S............#......#
#...........#..........#..............##
#........................#..#....#.#...#
#......................#...............#
#....#..#...#..........................#
#.#.............#........#.............#
#...................#......#...........#
#.#..........#..........#..............#
#.....................#................#
#......................#.#.#...........#
#......................................#
#......#..............#..#..........#.##
#......................................#
#....#.......#....#....................#
#...................#........#.........#
#...#..#....#.#...................##...#
#...............................#......#
#.........##.........#........#...#....#
#....#...#...#....#........#...........#
#......................................#
#............#................#.....#..#
#...#..................#...............#
#......................................#
#...........#..........................#
#...##.#...............................#
#.....#............#...........#.......#
#......#....#...#.....#...#............#
#...........#.....##..............##.#.#
#.##..........#.#.......#..............#
#....#.......#.#.....#...........#.....#
#.......#.....#.....#...#...........#.##
#.......#.............#................#
########################################
