########################################
#................#.###...............#.#
#...#.....#...........#.......##.......#
#.....................#..#.##......#...#
#..........................#...........#
#......#...#...#.............#........##
#......................................#
#......#.....................#.....##..#
#.................#....##.......##.#...#
#......#...#....#.....#..........#.....#
#..#.........##.....#..................#
#..........#...#.......G..#............#
#....#....#..#.........#...............#
#......................................#
#..#..................##...............#
#.#................#.#.................#
#......#...............................#
#..#.......##....#.........##.........##
#............#................#.#.....##
#..................#......#............#
#..........#...#....#..................#
##.#..#.......#.....#..............#...#
#...#.............##............#.#.#..#
#..................#........S.....#....#
#.............##.....#..###............#
#.......#..................#....#.#....#
#....#.#...#.............#.....#......##
#..............#...........#...........#
#...........................#....###...#
#......#............#..#..............##
#...#......#.........#.#...............#
#.#...#................................#
#............#....................##...#
#.......#.....#.............#..........#
#.#..#..........#.....#................#
#...#..#..#.#................#.........#
#................#......#...........#..#
#.....#.........#.................#....#
#...........#........#...........#.....#
########################################
