########################################
#.#.#....#................#.......#....#
#............#..#.....#................#
#.#........#...........................#
#......#.....G...........#......#......#
#................#.....................#
#......#...#........................#..#
#........#...#............#..#........##
#....#..##.#.................#.......#.#
#............##.#.....#................#
#..............#........#..............#
#...#.................#......#..#.....##
#......#............#.........#.#......#
#....#...#.#...............#...........#
#..........#.............#......#......#
#......#..............#.............#..#
#..........#.....#...........##........#
#.....................#.#..............#
#.............##...#...................#
##...........#..........#..............#
#...#........#.........#.#.......#.....#
#.........#......#....#.........#......#
#.......#...........##....#...#.....#..#
#.......#.............#.....#.....#....#
#.#............#.....#..#.....#........#
#...#......##....S.....................#
#...........#.....#....................#
#.............#..#..#.............#....#
#....#................#.##.....##...#..#
#..................#...............#...#
#........#...........#..#..............#
#.............#..#......#..............#
#........#...#.#........#..............#
#....................#.................#
##....##........#.#..#.................#
#..........#...........#..#............#
#.....................#................#
#.........#.........#...........#......#
#.......#..........#...................#
########################################
