########################################
#..#..............................#....#
#..##........#..................##..#..#
#......................................#
#...........#.#........#...........#...#
#.#..............#.....................#
#....................................#.#
#...................#...S..#...........#
#............#..#......#.#............##
#.......#...................#..........#
#.#.#....................#.##......#...#
#..............#...........#...........#
#..................#...............#...#
#...............#..#........#.......##.#
#.#............#...............#....#..#
#....#.............#..#................#
#.......#...#...#....................#.#
##......#.#...#......##.........#......#
##...........#.....#.#.#...#...........#
#....#........#................#.......#
#..........G....#...........#..........#
#.#..........#...........#........#....#
#.#..............#...................#.#
#..............#............##.........#
#....................................#.#
#..............................#..#.#..#
#.........#..#..........###............#
#.#..#.....................#.#.........#
#..........#...........................#
#......#......#........#...............#
#.....#..........#.................#...#
#.#...#............###...#........##..##
#...............#......#...............#
#..............................#.......#
#..........#...........................#
#..#....................#..............#
#...#........#.........................#
#....#...#.#................##.........#
#......................................#
########################################
