########################################
#......................................#
#......#...............#.....#.........#
#..#...#...............................#
#...#.........#......#....#............#
#...............#..........#...........#
#.#.......................#............#
#..#.........#.......#.................#
#.................#....................#
#.........#.........#......#....#......#
#.........##......#....................#
#..##....#.............................#
#.....#...#...#..........#....#..#....##
#......#............#..................#
#........#..............#.............##
##.....##..........................#...#
##...............#....................##
#.............#...................#....#
#..##.#..............#...#.............#
#..................##...#.#.#........S.#
#..#......#...#..............#......#..#
#.............#..................#.....#
#........#...............#....#.......##
#.....#.....#.........#..#......#..#...#
#......#.........G......#.............##
#..#..................#................#
#....#............#.....#............#.#
#.....................#......#...#.....#
#..........#...........#....#..#.......#
#...#.....##.............#............##
#..............#........#..#...........#
#.......#...........#..........#..#...##
#..#........#.........#.#......#.......#
#.............#...........#.........#..#
#....#.........................###.....#
#.##...........#......#................#
#.......##...#..#........#..#..........#
#..................#....#.#.#..........#
#.....#.......................#........#
########################################
