########################################
#...........##.............#...........#
#..............................#...#...#
#........#....G........#...............#
#....................#.....#........##.#
#.............#....................#...#
#............#.#....#..##..#.........#.#
#........#......#................#.....#
#..........#..#......#...............#.#
##........###............##.........#..#
#...#...................#..............#
#......#..........#....#.......#.......#
#...................#.#.....#..........#
#..#........#........................#.#
#.........#...#...........###..........#
#............#.#...#.#.......#.........#
#......#...........#...................#
#.........#..........#.................#
#.#.....#...#.........#.......#........#
#..#.....#.#..#...#......#.............#
#............#.....#..#...#..........#.#
#...........#.................#........#
#....#.................#..............##
#.....##...............................#
#.........#...........#...........#....#
#..#............#................#.....#
#..........#.....S......#.........#....#
#...........#..........................#
#...#.....................#.....#.##...#
##..............#....#........#....##..#
#.................#....#...............#
##......#.#.......#..#..........#....#.#
#.#....#................#..............#
#........#..#.....#....................#
#.....#..#.....#.............#...#.....#
#.....##........#..................#...#
#.#....................................#
#............#.....................#...#
#......................................#
########################################
