########################################
#.................##...................#
#.......#....#.#...........#...#.......#
#..#.#.....##.....#....#........#......#
#........................#............##
#...#.#................................#
#....#....#....#.......................#
#...#.#...#.........#...#.#............#
##....#....................#........#..#
###.......##..........#......#.........#
#.......#......#........#..............#
#....#......#........................#.#
#......................................#
#..........#...................##...#..#
##.#...........#......#.............#..#
#...........#......#.....#.............#
#..#.#..#..............#.#.............#
#..#...........#..#....................#
#...........#......................#...#
#...#..............................#...#
##..#.S.#...#..........................#
#......##...........#..................#
#..........#......................G....#
#..#.....................#........#.#..#
#....#..#.#.#........#.................#
#..........##......................#...#
#.................#..#......##.........#
#..................#..#...............##
#.....##....#.................#....#...#
#...........#....#..............#....#.#
#..##.......#.....................#..#.#
#...#...#..............#...............#
##..#...........##....#...........#...##
#.#....................................#
#.........#............##....#.........#
#................#.#.#.................#
#....#..............#...............#..#
#..............#...#......##...#.......#
#...##..............#....#.....#.......#
########################################
