########################################
#......................................#
#...........#...#............#.......#.#
#......##.............#.............#..#
##.......#........................##...#
#..#......#.........#..................#
#....................#.#...............#
#....#.............#..#....#.#.........#
#..........#.#....................#..S.#
#....#.................................#
#.....................#..##.....#......#
#.........#.....#................#.....#
#...#..#........#......................#
#..........#........##...............#.#
##.##..#........#.#.#..........#.......#
#......#..#...#.............#....#.....#
#....#........................#........#
#......#...........#.#.............#...#
#.......#............#........#........#
#......................................#
#....#..............#...#..............#
#.....#...#.#..........................#
#...........#......#.........#...#.....#
#.......#.....#............#...........#
#......G...............................#
#......#..#..................#.......#.#
#............................#.........#
###....#..............................##
#.....................#..#.....#.......#
#.#....................#...#...........#
#...........#..........#..............##
###......##.........#..................#
#....#....#................#...........#
##...#.........................#.......#
#....#..#..#.....#..#...........#....#.#
#......................................#
#...#.#..#..........#..........#......##
#.#...............#...........#........#
#..................................#...#
########################################
